এবং  :  এবং
হয়  :  হয়
করা  :  করা
সালে  :  সাল
পাওয়া  :  পাওয়া
যায়  :  যায়
আরবি  :  আরবি
হয়েছে  :  হয়েছ
রয়েছে  :  রয়েছ
প্রাচীন  :  প্রাচীন
সালের  :  সাল
হিসেবে  :  হিসেব
আইন  :  আইন
প্রাপ্ত  :  প্রাপ্ত
কাজ  :  কাজ
বাংলাদেশের  :  বাংলাদেশ
কোন  :  কোন
হতো  :  হতো
দক্ষিণ  :  দক্ষিণ
হচ্ছে  :  হচ্ছ
তৈরি  :  তৈরি
সরকার  :  সরকা
বিহার  :  বিহা
প্রধান  :  প্রধান
সংরক্ষণ  :  সংরক্ষণ
তবে  :  তবে
গেছে  :  গেছ
প্রত্নতাত্ত্বিক  :  প্রত্নতাত্ত্বিক
গুরুত্বপূর্ণ  :  গুরুত্বপূর্ণ
উত্তর  :  উত্ত
অঞ্চলের  :  অঞ্চল
বৌদ্ধ  :  বৌদ্ধ
ধারা  :  ধারা
উৎখনন  :  উৎখনন
মাদ্রাসা  :  মাদ্রাসা
অঞ্চলে  :  অঞ্চল
নামে  :  নাম
খনন  :  খনন
আর্কিওলজিক্যাল  :  আর্কিওলজিক্যাল
হয়েছিল  :  হয়েছিল
হতে  :  হতে
মুসলিম  :  মুসলিম
বিভিন্ন  :  বিভিন্ন
নতুন  :  নতুন
তাদের  :  তাদ
অঞ্চল  :  অঞ্চল
ভূগর্ভস্থ  :  ভূগর্ভস্থ
জেলার  :  জেলা
উৎকীর্ণ  :  উৎকীর্ণ
হয়ে  :  হয়
মূর্তি  :  মূর্তি
মুদ্রা  :  মুদ্র
বলে  :  বলে
প্রথম  :  প্রথম
দেওয়া  :  দেওয়া
ঐতিহাসিক  :  ঐতিহাসিক
অন্যান্য  :  অন্যান্য
অনুসন্ধান  :  অনুসন্ধান
সময়  :  সময়
শুরু  :  শুরু
নির্মিত  :  নির্মিত
নিদর্শন  :  নিদর্শন
কাজের  :  কাজ
প্রায়  :  প্রায়
পূর্ব  :  পূর্ব
নয়  :  নয়
জলস্তর  :  জলস্ত
চট্টগ্রাম  :  চট্টগ্রাম
গ্রহণ  :  গ্রহণ
গিয়েছে  :  গিয়েছ
একজন  :  একজন
অব  :  অব
সরকারের  :  সরকার
যুগের  :  যুগ
মন্দির  :  মন্দি
বাংলার  :  বাংলা
বাংলাদেশে  :  বাংলাদেশ
বাংলাদেশ  :  বাংলাদেশ
প্রত্নতত্ত্ব  :  প্রত্নতত্ত্ব
পোড়ামাটির  :  পোড়ামা
দ্বারা  :  দ্বার
জরিপ  :  জরিপ
কেন্দ্রীয়  :  কেন্দ্রীয়
এগুলি  :  এগুলি
অনুযায়ী  :  অনুযায়ী
যদি  :  যদি
প্রতিষ্ঠিত  :  প্রতিষ্ঠিত
প্রকাশ  :  প্রকাশ
নি  :  নি
ধরনের  :  ধরন
এক  :  এক
অবস্থিত  :  অবস্থিত
স্থানে  :  স্থান
সৃষ্টি  :  সৃষ্
সার্ভে  :  সার্ভ
সকল  :  সকল
শতক  :  শতক
ফলক  :  ফলক
প্রত্নস্থল  :  প্রত্নস্থল
প্রত্নবস্ত্ত  :  প্রত্নবস্ত্ত
প্রত্ননিদর্শন  :  প্রত্ননিদর্শন
পাহাড়পুর  :  পাহাড়পু
পশ্চিম  :  পশ্চিম
পরিচালনা  :  পরিচালনা
নিয়োগ  :  নিয়োগ
দেশের  :  দেশ
দিক  :  দিক
উল্লেখযোগ্য  :  উল্লেখযোগ্য
স্মৃতিসৌধ  :  স্মৃতিসৌধ
স্থাপন  :  স্থাপন
সালিশকারী  :  সালিশকারী
সাল  :  সাল
সম্পর্কে  :  সম্পর্ড
লিপি  :  লিপি
বেশি  :  বেশি
পরিচালিত  :  পরিচালিত
নিকট  :  নিকট
ধারণা  :  ধারণা
কর্তৃক  :  কর্তৃক
কয়েকটি  :  কয়েক
হাতিয়ার  :  হাতিয়া
স্থাপত্য  :  স্থাপত্য
সালিশি  :  সালিশি
সম্ভবত  :  সম্ভবত
সংগ্রহ  :  সংগ্রহ
শালবন  :  শালবন
রপ্তানি  :  রপ্তা
যেমন  :  যেমন
যাবে  :  যাব
ময়নামতীর  :  ময়নামতী
ভারতের  :  ভারত
ভারত  :  ভারত
বিষয়ে  :  বিষয়
বিভাগ  :  বিভাগ
বাংলা  :  বাংলা
বর্তমানে  :  বর্তমান
প্রদান  :  প্রদান
পরবর্তী  :  পরবর্তী
নিয়ে  :  নিয়
ধর্মীয়  :  ধর্মীয়
দায়িত্ব  :  দায়িত্ব
ঢাকা  :  ঢাকা
গড়ে  :  গড়
কানিংহাম  :  কানিংহাম
এসব  :  এসব
আরাকানের  :  আরাকান
আরব  :  আরব
হবে  :  হবে
স্থানীয়  :  স্থানীয়
সুপারিন্টেনডেন্ট  :  সুপারিন্টেনডেন্ট
সাংস্কৃতিক  :  সাংস্কৃতিক
সময়ে  :  সময়
শব্দ  :  শব্দ
রাজা  :  রাজা
ভাষা  :  ভাষা
ব্যবহূত  :  ব্যবহূত
বাংলায়  :  বাংলায়
বলা  :  বলা
প্রদেশ  :  প্রদেশ
প্রতিবেদন  :  প্রতিবেদন
পূর্বে  :  পূর্ব
দিয়ে  :  দিয়
দিকে  :  দিক
তিনটি  :  তিন
তমলুক  :  তমলুক
এন  :  এন
ইতিহাসের  :  ইতিহাস
অতি  :  অতি
শুধু  :  শুধু
শতকের  :  শতক
মুড়া  :  মুড়া
ময়নামতী  :  ময়নামতী
বিস্তৃত  :  বিস্তৃত
বিষয়  :  বিষয়
বসতি  :  বসতি
ফলে  :  ফলে
পাথরের  :  পাথর
নিযুক্ত  :  নিযুক্ত
ছাড়া  :  ছাড়া
গ্রন্থ  :  গ্রন্থ
গুরুত্ব  :  গুরুত্ব
খ্রিস্টাব্দে  :  খ্রিস্টাব্দ
ক্ষুদ্র  :  ক্ষুদ্
ক্ষমতা  :  ক্ষমতা
কে  :  কে
কারণে  :  কারণ
এগুলির  :  এগুলি
আদি  :  আদি
সুযোগ  :  সুযোগ
সাথে  :  সাথ
সংরক্ষণের  :  সংরক্ষণ
শিক্ষা  :  শিক্ষা
লাভ  :  লাভ
রোয়েদাদ  :  রোয়েদাদ
মনে  :  মনে
ভাস্কর্য  :  ভাস্কর্য
বছর  :  বছর
পুনরায়  :  পুনরায়
পাহাড়পুরের  :  পাহাড়পুর
পরিচালকের  :  পরিচালক
নানা  :  নানা
তারা  :  তারা
ঢাকার  :  ঢাকা
ছোট  :  ছোট
কার্যক্রম  :  কার্যক্রম
কথা  :  কথা
এলাকায়  :  এলাকায়
এলাকা  :  এলাকা
উল্লেখ  :  উল্লেখ
উন্মোচিত  :  উন্মোচিত
আরাকান  :  আরাকান
আবিষ্কার  :  আবিষ্কা
আড়াইহাজার  :  আড়াইহাজা
আকারের  :  আকার
অনুসরণ  :  অনুসরণ
অধীনে  :  অধীন
অধীন  :  অধীন
হয়নি  :  হয়
স্থান  :  স্থান
স্তর  :  স্ত
সোসাইটি  :  সোসাই
সিদ্ধান্ত  :  সিদ্ধান্ত
সহকারী  :  সহকারী
সরকারি  :  সরকারি
সংশ্লিষ্ট  :  সংশ্লিষ্ট
শাহ  :  শাহ
শতকে  :  শতক
রীতির  :  রীতি
রিপোর্ট  :  রিপোর্ট
রাজনৈতিক  :  রাজনৈতিক
যোগাযোগ  :  যোগাযোগ
যেকোন  :  যেকোন
মূর্তির  :  মূর্তি
ভাসু  :  ভাসু
ভাষায়  :  ভাষায়
ব্রোঞ্জ  :  ব্রোঞ্জ
বিহারে  :  বিহার
বিশিষ্ট  :  বিশিষ্ট
বিলুপ্ত  :  বিলুপ্ত
বিভাগের  :  বিভাগ
বর্তমান  :  বর্তমান
বরেন্দ্র  :  বরেন্দ্
বন্ধ  :  বন্ধ
বন্দর  :  বন্দ
বড়  :  বড়
ফসিল  :  ফসিল
প্রস্তাব  :  প্রস্তাব
প্রভৃতি  :  প্রভৃতি
প্রণীত  :  প্রণীত
প্রকাশিত  :  প্রকাশিত
পাকিস্তান  :  পাকিস্তান
পর্যাপ্ত  :  পর্যাপ্ত
পদ  :  পদ
নাম  :  নাম
দুই  :  দুই
তথ্য  :  তথ্য
তখন  :  তখন
জাহাঙ্গীরনগর  :  জাহাঙ্গীরনগ
চবিবশ  :  চবিবশ
গুপ্ত  :  গুপ্ত
গবেষণা  :  গবেষণা
গঠিত  :  গঠিত
কুরআন  :  কুরআন
উভয়  :  উভয়
ইসলাম  :  ইসলাম
আবিষ্কৃত  :  আবিষ্কৃত
আইনের  :  আইন
অবশ্য  :  অবশ্য
অধিকাংশ  :  অধিকাংশ
অংশ  :  অংশ
হাতে  :  হাত
হওয়ার  :  হওয়া
সি  :  সি
সাহিত্য  :  সাহিত্য
সাম্প্রতিক  :  সাম্প্রতিক
সাধারণ  :  সাধারণ
সরকারকে  :  সরকারড
সবচেয়ে  :  সবচেয়
সংরক্ষিত  :  সংরক্ষিত
সংক্রান্ত  :  সংক্রান্ত
শেষ  :  শেষ
শিক্ষার  :  শিক্ষা
শাখা  :  শাখা
শহর  :  শহর
শব্দের  :  শব্
শনাক্ত  :  শনাক্ত
লর্ড  :  লর্ড
রোহিঙ্গ্যা  :  রোহিঙ্গ্যা
যুক্ত  :  যুক্ত
মিলিয়ন  :  মিলিয়ন
মিটার  :  মিটা
মাটির  :  মাটি
মহাস্থান  :  মহাস্থান
মহা  :  মহা
মধ্যযুগের  :  মধ্যযুগ
মঠ  :  মঠ
ভারতীয়  :  ভারতীয়
ব্রোঞ্জের  :  ব্রোঞ্জ
ব্রিটিশ  :  ব্রিটিশ
ব্যাপক  :  ব্যাপক
ব্যাংক  :  ব্যাংক
ব্যবস্থা  :  ব্যবস্থা
বিস্তারিত  :  বিস্তারিত
বিশ্ববিদ্যালয়ের  :  বিশ্ববিদ্যালয়
বিবদমান  :  বিবদমান
বার্মা  :  বার্মা
বার্জেস  :  বার্জেস
বাতিল  :  বাতিল
বাজার  :  বাজা
বছরের  :  বছর
প্রাথমিক  :  প্রাথমিক
প্রমাণ  :  প্রমাণ
পাহাড়পুরে  :  পাহাড়পুর
পাল  :  পাল
পাঞ্জাব  :  পাঞ্জাব
পর্যায়ে  :  পর্যায়
পরিবর্তন  :  পরিবর্তন
পরিকল্পনা  :  পরিকল্পনা
পদে  :  পদে
নির্দেশ  :  নির্দেশ
নামক  :  নামক
দেশে  :  দেশ
দেখা  :  দেখা
দুর্গ  :  দুর্গ
তিন  :  তিন
ডাইরেক্টর  :  ডাইরেক্ট
জানা  :  জানা
চারপত্র  :  চারপত্
কাল  :  কাল
কার্য  :  কার্য
করেছে  :  করেছ
কয়েক  :  কয়েক
ওপর  :  ওপর
এগুলোর  :  এগুল
একক  :  একক
উয়ারী  :  উয়ারী
উন্নত  :  উন্নত
উদ্যোগে  :  উদ্যোগ
ইন্ডিয়ার  :  ইন্ডিয়া
আরাকানে  :  আরাকান
আরবিতে  :  আরবি
অস্তিত্ব  :  অস্তিত্ব
অর্থাৎ  :  অর্থাৎ
অন্তর্ভুক্ত  :  অন্তর্ভুক্ত
অধিকাংশই  :  অধিকাংশই
স্যার  :  স্যা
স্বাধীনতা  :  স্বাধীনতা
সেখানে  :  সেখান
সুপারিশ  :  সুপারিশ
সুপরিচিত  :  সুপরিচিত
সার্ভের  :  সার্ভ
সময়ের  :  সময়
সমগ্র  :  সমগ্
সংস্কৃত  :  সংস্কৃত
সংযুক্ত  :  সংযুক্ত
সংখ্যা  :  সংখ্যা
সংখ্যক  :  সংখ্যক
লিপির  :  লিপি
রৌপ্য  :  রৌপ্য
রিসার্চ  :  রিসার্চ
রায়  :  রায়
রচনা  :  রচনা
র  :  র
যৌথ  :  যৌথ
যুগে  :  যুগ
মাদ্রাসার  :  মাদ্রাসা
মাইল  :  মাইল
মসজিদ  :  মসজিদ
ময়নামতীতে  :  ময়নামতী
মধ্য  :  মধ্য
ভ্রমণ  :  ভ্রমণ
ভূমিকা  :  ভূমিকা
ভূ  :  ভূ
ভাষার  :  ভাষা
ব্যাংকের  :  ব্যাংক
ব্যতীত  :  ব্যতীত
ব্যক্তি  :  ব্যক্তি
বৃহত্তর  :  বৃহত্ত
বৃক্ষবিদ্যা  :  বৃক্ষবিদ্যা
বিহারের  :  বিহার
বিশ্ববিদ্যালয়  :  বিশ্ববিদ্যালয়
বিদেশী  :  বিদেশী
বালি  :  বালি
বানিজ্যিক  :  বানিজ্যিক
বটেশ্বর  :  বটেশ্ব
ফলকে  :  ফলক
প্রাদেশিক  :  প্রাদেশিক
প্রত্নস্থলের  :  প্রত্নস্থল
প্রত্নতত্ত্বের  :  প্রত্নতত্ত্ব
প্রতিষ্ঠার  :  প্রতিষ্ঠা
প্রতিষ্ঠান  :  প্রতিষ্ঠান
প্রতিটি  :  প্রতি
পূর্ণ  :  পূর্ণ
পুরুষ  :  পুরুষ
পালন  :  পালন
পারেন  :  পারেন
পাথুরে  :  পাথুর
পশ্চিমে  :  পশ্চিম
পরিমাণ  :  পরিমাণ
পরিচিত  :  পরিচিত
পরিচালক  :  পরিচালক
নির্মাণ  :  নির্মাণ
নিজস্ব  :  নিজস্ব
নদীর  :  নদী
ধ্বংসাবশেষের  :  ধ্বংসাবশেষ
ধ্বংসাবশেষ  :  ধ্বংসাবশেষ
ধর্ম  :  ধর্ম
দ্বিতীয়  :  দ্বিতীয়
দেব  :  দেব
দৃশ্য  :  দৃশ্য
দক্ষিণে  :  দক্ষিণ
থেকেই  :  থেকেই
ঢিবি  :  ঢিবি
ট্রেজার  :  ট্রেজা
জলবাহী  :  জলবাহী
জরিপের  :  জরিপ
ছাঁচে  :  ছাঁচ
চালু  :  চালু
চর্চার  :  চর্চা
চন্দ্রকেতুগড়  :  চন্দ্রকেতুগড়
ঘোষণা  :  ঘোষণা
গৃহীত  :  গৃহীত
গিয়েছিল  :  গিয়েছিল
খান  :  খান
কুটিলা  :  কুটিলা
কার্যকর  :  কার্যক
কাঠের  :  কাঠ
কলকাতা  :  কলকাতা
করেছিল  :  করেছিল
কম  :  কম
কক্ষ  :  কক্ষ
এছাড়া  :  এছাড়া
উদাহরণ  :  উদাহরণ
ইমারত  :  ইমারত
ই  :  ই
আলেকজান্ডার  :  আলেকজান্ডা
আল  :  আল
আরাকানি  :  আরাকা
আরবদের  :  আরব
আন্তর্জাতিক  :  আন্তর্জাতিক
আনা  :  আনা
অর্থনৈতিক  :  অর্থনৈতিক
অব্যাহত  :  অব্যাহত
অনুমোদন  :  অনুমোদন
অধিগ্রহণ  :  অধিগ্রহণ
অত্যন্ত  :  অত্যন্ত
অতিরিক্ত  :  অতিরিক্ত
হিন্দু  :  হিন্দু
হিউয়েন  :  হিউয়েন
হরিনারায়ণপুর  :  হরিনারায়ণপু
স্পষ্ট  :  স্পষ্ট
স্থলে  :  স্থল
সেন  :  সেন
সূক্ষ্ম  :  সূক্ষ্ম
সুলতান  :  সুলতান
সিন্ধু  :  সিন্ধু
সাধিত  :  সাধিত
সাধারণত  :  সাধারণত
সাধন  :  সাধন
সাত  :  সাত
সাং  :  সাং
সম্বলিত  :  সম্বলিত
সম্পর্কিত  :  সম্পর্কিত
সম্পর্ক  :  সম্পর্ক
সমুদ্র  :  সমুদ্
সমিতি  :  সমিতি
সংস্কৃতির  :  সংস্কৃতি
সংশোধন  :  সংশোধন
শেষে  :  শেষ
শাসনামলে  :  শাসনামল
শায়খ  :  শায়খ
শহীদ  :  শহীদ
শহরের  :  শহর
শব্দটি  :  শব্দ
লিপিবিদ  :  লিপিবিদ
লক্ষ্যে  :  লক্ষ্য
রূপবান  :  রূপবান
রিপোর্টটি  :  রিপোর্ট
রাজশাহীর  :  রাজশাহী
রচিত  :  রচিত
যৌগিক  :  যৌগিক
মৌর্য  :  মৌর্য
মৃত্যু  :  মৃত্যু
মূল্যবান  :  মূল্যবান
মূলত  :  মূলত
মূল  :  মূল
মুসলমানদের  :  মুসলমান
মুড়ায়  :  মুড়ায়
মুক্তিযোদ্ধারা  :  মুক্তিযোদ্ধার
মাসে  :  মাস
মানের  :  মান
মাদ্রাজ  :  মাদ্রাজ
মাঝে  :  মাঝ
মাঝ  :  মাঝ
মসৃণ  :  মসৃণ
মন্দিরটি  :  মন্দির
মকতব  :  মকতব
ভিত্তিতে  :  ভিত্তি
ভারতে  :  ভার
ব্যাকরণ  :  ব্যাকরণ
ব্যাংকটির  :  ব্যাংক
ব্যবসায়ী  :  ব্যবসায়ী
বোম্বে  :  বোম্ব
বৈশিষ্ট্য  :  বৈশিষ্ট্য
বেসরকারি  :  বেসরকারি
বেঙ্গল  :  বেঙ্গল
বিরোধ  :  বিরোধ
বিদেশি  :  বিদেশি
বিজ্ঞান  :  বিজ্ঞান
বিচ্ছিন্ন  :  বিচ্ছিন্ন
বিখ্যাত  :  বিখ্যাত
বিকাশ  :  বিকাশ
বি  :  বি
বাণিজ্যের  :  বাণিজ্য
বাণিজ্যিক  :  বাণিজ্যিক
প্রাণী  :  প্রাণী
প্রয়োজন  :  প্রয়োজন
প্রদত্ত  :  প্রদত্ত
প্রত্নস্থলে  :  প্রত্নস্থল
প্রতিষ্ঠা  :  প্রতিষ্ঠা
প্রতি  :  প্রতি
প্রকৃতি  :  প্রকৃতি
পো  :  পো
পেশ  :  পেশ
পারবে  :  পারব
পানি  :  পানি
পাত্র  :  পাত্
পাঠান  :  পাঠান
পর্বে  :  পর্ব
পরিদর্শন  :  পরিদর্শন
পরিচয়  :  পরিচয়
নেতৃত্বে  :  নেতৃত্ব
নিষিদ্ধ  :  নিষিদ্ধ
নিয়ন্ত্রণ  :  নিয়ন্ত্রণ
নিদর্শনের  :  নিদর্শন
নিদর্শনসমূহের  :  নিদর্শনসমূহ
নারী  :  নারী
নামকরণ  :  নামকরণ
নভেম্বর  :  নভেম্ব
নগর  :  নগর
নকশার  :  নকশা
নকশা  :  নকশা
ধারাবাহিকতায়  :  ধারাবাহিকতায়
দেউলপোতা  :  দেউলপোতা
দুইজন  :  দুইজন
থাকায়  :  থাকায়
তৃতীয়  :  তৃতীয়
তিনজন  :  তিনজন
তাঁরা  :  তাঁর
ড  :  ড
ট্রাইব্যুনালের  :  ট্রাইব্যুনাল
জেনারেল  :  জেনারেল
জুড়ে  :  জুড়
ছাপাঙ্কিত  :  ছাপাঙ্কিত
ছাত্ররা  :  ছাত্রর
ছাত্র  :  ছাত্
ছাড়াও  :  ছাড়াও
চেয়ে  :  চেয়
চন্দ্র  :  চন্দ্
গঠন  :  গঠন
খ্রিস্টীয়  :  খ্রিস্টীয়
খ্রি  :  খ্রি
ক্রুশাকৃতি  :  ক্রুশাকৃতি
ক্রিয়াপদের  :  ক্রিয়াপ
কোথাও  :  কোথাও
কোট  :  কোট
কেন্দ্র  :  কেন্দ্
কৃষি  :  কৃষি
কালো  :  কাল
কাদার  :  কাদা
কাঠ  :  কাঠ
করত  :  করত
কতিপয়  :  কতিপয়
এলাকার  :  এলাকা
এদেশের  :  এদেশ
এছাড়াও  :  এছাড়াও
এগুলিতে  :  এগুলি
একমাত্র  :  একমাত্
এইচ  :  এইচ
উৎখননের  :  উৎখনন
উল্লিখিত  :  উল্লিখিত
উপমহাদেশের  :  উপমহাদেশ
উপদেষ্টা  :  উপদেষ্টা
উদ্দেশ্যে  :  উদ্দেশ্য
উঠেছিল  :  উঠেছিল
উচ্চ  :  উচ্চ
ইসলামী  :  ইসলামী
ইন্ডিয়া  :  ইন্ডিয়া
আসে  :  আসে
আসাম  :  আসাম
আশ্রয়  :  আশ্রয়
আলাদা  :  আলাদা
আট  :  আট
আগস্ট  :  আগস্ট
আইনে  :  আইন
অর্থ  :  অর্থ
অন্যদিকে  :  অন্যদিড
অনুমতি  :  অনুমতি
অংশে  :  অংশ
হোসেন  :  হোসেন
হুগলি  :  হুগলি
হুইলার  :  হুইলা
হাদীস  :  হাদীস
হাতিয়ারের  :  হাতিয়ার
হাজার  :  হাজা
হওয়া  :  হওয়া
স্বাধীন  :  স্বাধীন
স্বর্ণ  :  স্বর্ণ
স্থাপনা  :  স্থাপনা
স্থানের  :  স্থান
স্থলাভিষিক্ত  :  স্থলাভিষিক্ত
স্তরে  :  স্তর
সেগুলোর  :  সেগুল
সেক্ষেত্রে  :  সেক্ষেত্র
সেক্রেটারি  :  সেক্রেটারি
সুফি  :  সুফি
সুপারিন্টেডেন্টের  :  সুপারিন্টেডেন্ট
সু  :  সু
সীতাকোট  :  সীতাকোট
সিলেটের  :  সিলেট
সালিশকারীরা  :  সালিশকারীর
সালিশকারীর  :  সালিশকারী
সার্ভেকে  :  সার্ভেড
সার্বিক  :  সার্বিক
সাময়িকভাবে  :  সাময়িকভাব
সামগ্রী  :  সামগ্রী
সামগ্রিক  :  সামগ্রিক
সম্ভাবনা  :  সম্ভাবনা
সম্ভব  :  সম্ভব
সম্পৃক্ত  :  সম্পৃক্ত
সমসাময়িক  :  সমসাময়িক
সংস্কারের  :  সংস্কার
সংগ্রহের  :  সংগ্রহ
সংগৃহীত  :  সংগৃহীত
শ্রেণি  :  শ্রেণি
শৈল্পিক  :  শৈল্পিক
শুরুতে  :  শুরু
শিল্প  :  শিল্প
শিলালিপি  :  শিলালিপি
শিক্ষাপ্রতিষ্ঠান  :  শিক্ষাপ্রতিষ্ঠান
শাসনের  :  শাসন
শাসন  :  শাসন
লেখা  :  লেখা
লিমিটেড  :  লিমিটেড
লাইসেন্স  :  লাইসেন্স
লক্ষ্য  :  লক্ষ্য
রীতি  :  রীতি
রাজার  :  রাজা
রাজশাহী  :  রাজশাহী
রাজপুতনা  :  রাজপুতনা
রাজধানী  :  রাজধানী
রহিত  :  রহিত
রপ্তানির  :  রপ্তা
রত্ন  :  রত্ন
যাহোক  :  যাহোক
যাতে  :  যাত
যথা  :  যথা
যখন  :  যখন
মেদিনীপুর  :  মেদিনীপু
মেঘনা  :  মেঘনা
মৃৎপাত্র  :  মৃৎপাত্
মূল্য  :  মূল্য
মুসলমান  :  মুসলমান
মুড়ার  :  মুড়া
মুক্তিযোদ্ধাদের  :  মুক্তিযোদ্ধা
মুক্তিযোদ্ধা  :  মুক্তিযোদ্ধা
মালিকানা  :  মালিকানা
মাত্র  :  মাত্
মাঝারি  :  মাঝারি
মা  :  মা
মহাস্থানগড়ের  :  মহাস্থানগড়
মহাস্থানগড়  :  মহাস্থানগড়
মহাপরিচালকের  :  মহাপরিচালক
মহাপরিচালক  :  মহাপরিচালক
মন্দিরের  :  মন্দির
মত  :  মত
মওলানা  :  মওলানা
ভেতর  :  ভেত
ভূমিতে  :  ভূমি
ভূমি  :  ভূমি
ভিত্তি  :  ভিত্তি
ভাবা  :  ভাবা
ভবিষ্যৎ  :  ভবিষ্যৎ
ব্রহ্মপুত্র  :  ব্রহ্মপুত্
ব্যাখ্যা  :  ব্যাখ্যা
ব্যাংকিং  :  ব্যাংকিং
ব্যবস্থাপনা  :  ব্যবস্থাপনা
বৈশিষ্ট্যপূর্ণ  :  বৈশিষ্ট্যপূর্ণ
বৃহত্তম  :  বৃহত্তম
বৃদ্ধি  :  বৃদ্ধি
বিস্ময়কর  :  বিস্ময়ক
বিষয়ের  :  বিষয়
বিষয়ক  :  বিষয়ক
বিশ্বের  :  বিশ্ব
বিশ্ববিদ্যালয়ে  :  বিশ্ববিদ্যালয়
বিশেষত  :  বিশেষত
বিশেষজ্ঞ  :  বিশেষজ্ঞ
বিশৃঙ্খলা  :  বিশৃঙ্খলা
বিরুদ্ধে  :  বিরুদ্ধ
বিভক্ত  :  বিভক্ত
বিবেচিত  :  বিবেচিত
বিবেচনা  :  বিবেচনা
বিবরণ  :  বিবরণ
বিধান  :  বিধান
বিদ্যমান  :  বিদ্যমান
বিচারে  :  বিচার
বাহাদুর  :  বাহাদু
বারো  :  বার
বাঙ্গাল  :  বাঙ্গাল
বস্ত্ত  :  বস্ত্ত
বর্ণনা  :  বর্ণনা
বগুড়ার  :  বগুড়া
প্রাগৈতিহাসিক  :  প্রাগৈতিহাসিক
প্রাকৃতিক  :  প্রাকৃতিক
প্রশাসন  :  প্রশাসন
প্রয়োজনে  :  প্রয়োজন
প্রমাণিত  :  প্রমাণিত
প্রভাব  :  প্রভাব
প্রবেশ  :  প্রবেশ
প্রবর্তন  :  প্রবর্তন
প্রত্যেক  :  প্রত্যেক
প্রত্নবস্ত্তর  :  প্রত্নবস্ত্ত
প্রচুর  :  প্রচু
প্রচলিত  :  প্রচলিত
প্রকাশনা  :  প্রকাশনা
প্রকার  :  প্রকা
পূর্ববর্তী  :  পূর্ববর্তী
পুরানো  :  পুরান
পুংলিঙ্গ  :  পুংলিঙ্গ
পাথর  :  পাথ
পাঠ্য  :  পাঠ্য
পাকবাহিনীর  :  পাকবাহিনী
পর্বের  :  পর্ব
পরিবার  :  পরিবা
পরিণত  :  পরিণত
পরিচালনার  :  পরিচালনা
পরবর্তীকালে  :  পরবর্তীকাল
পরগনার  :  পরগনা
পরগনা  :  পরগনা
পদ্ধতি  :  পদ্ধতি
পক্ষের  :  পক্ষ
পক্ষগুলোর  :  পক্ষ
পক্ষগুলির  :  পক্ষগুলি
পক্ষ  :  পক্ষ
ন্যস্ত  :  ন্যস্ত
নোয়াখালী  :  নোয়াখালী
নেয়  :  নেয়
নিশ্চিত  :  নিশ্চিত
নির্মাণকাল  :  নির্মাণকাল
নির্দিষ্ট  :  নির্দিষ্ট
নিয়োগের  :  নিয়োগ
নিদর্শনসমূহ  :  নিদর্শনসমূহ
নিচের  :  নিচ
নিউ  :  নিউ
নমুনা  :  নমুনা
নদীয়া  :  নদীয়া
ধ্বংস  :  ধ্বংস
ধারার  :  ধারা
ধারাবাহিক  :  ধারাবাহিক
দেয়া  :  দেয়া
দেওয়ানি  :  দেওয়া
দেউল  :  দেউল
দীর্ঘ  :  দীর্ঘ
দীক্ষিত  :  দীক্ষিত
দিনের  :  দিন
দশ  :  দশ
থানা  :  থানা
তৎকালীন  :  তৎকালীন
তিলদা  :  তিলদা
তাম্রলিপি  :  তাম্রলিপি
তাফসির  :  তাফসি
ডিগ্রি  :  ডিগ্রি
ডি  :  ডি
টিকে  :  টিক
টাকা  :  টাকা
জাতীয়  :  জাতীয়
জরিমানা  :  জরিমানা
জরিপকারক  :  জরিপকারক
জমিদার  :  জমিদা
জমা  :  জমা
ছবি  :  ছবি
চেয়ারম্যান  :  চেয়ারম্যান
চুক্তির  :  চুক্তি
চীনামাটির  :  চীনামা
চিত্র  :  চিত্
চারপাশে  :  চারপাশ
চারটি  :  চার
চর্চা  :  চর্চা
চমৎকার  :  চমৎকা
চন্দ্রকেতুগড়ের  :  চন্দ্রকেতুগড়
ঘটে  :  ঘটে
গ্রিক  :  গ্রিক
গ্রন্থে  :  গ্রন্থ
গুটিকা  :  গুটিকা
গভীর  :  গভী
গণ্য  :  গণ্য
খোদাই  :  খোদাই
খেলনা  :  খেলনা
খুঁজে  :  খুঁজ
ক্ষেত্রেই  :  ক্ষেত্রেই
ক্ষুদ্রাকৃতির  :  ক্ষুদ্রাকৃতি
ক্ষতি  :  ক্ষতি
কৌশল  :  কৌশল
কোম্পানি  :  কোম্পা
কেবল  :  কেবল
কেন্দ্রীভূত  :  কেন্দ্রীভূত
কেউ  :  কেউ
কুষাণ  :  কুষাণ
কুমিল্লার  :  কুমিল্লা
কিছুটা  :  কিছুটা
কালাম  :  কালাম
কালক্রমে  :  কালক্রম
কানিংহামের  :  কানিংহাম
কানিংহামকে  :  কানিংহামড
কাজী  :  কাজী
কর্মকর্তা  :  কর্মকর্তা
কয়েকজন  :  কয়েকজন
কমপক্ষে  :  কমপক্ষ
ওঠে  :  ওঠে
ঐতিহ্য  :  ঐতিহ্য
এ্যানসিয়েন্ট  :  এ্যানসিয়েন্ট
এ্যাক্ট  :  এ্যাক্ট
এসেছে  :  এসেছ
এসকল  :  এসকল
এশিয়াটিক  :  এশিয়াটিক
এরূপ  :  এরূপ
এম  :  এম
এবি  :  এবি
এফ  :  এফ
এদেশে  :  এদেশ
এগুলো  :  এগুল
এক্ষেত্রে  :  এক্ষেত্র
একমত  :  একমত
উৎখননে  :  উৎখনন
উপবিষ্ট  :  উপবিষ্ট
উপধারা  :  উপধার
উপজেলায়  :  উপজেলায়
উপকূলীয়  :  উপকূলীয়
উনিশ  :  উনিশ
উদ্ভূত  :  উদ্ভূত
উদ্ভব  :  উদ্ভব
ইসলামিক  :  ইসলামিক
ইমারতের  :  ইমারত
ইতোমধ্যে  :  ইতোমধ্য
ইতিহাস  :  ইতিহাস
আসত  :  আসত
আবু  :  আবু
আববাসীয়  :  আববাসীয়
আবদুল  :  আবদুল
আনুমানিক  :  আনুমানিক
আনন্দ  :  আনন্দ
আধুনিক  :  আধুনিক
আদালত  :  আদালত
আক্রমণ  :  আক্রমণ
অসংখ্য  :  অসংখ্য
অবয়ব  :  অবয়ব
অবদান  :  অবদান
অপরটি  :  অপর
অনুরূপ  :  অনুরূপ
অধ্যাদেশ  :  অধ্যাদেশ
অদ্যাবধি  :  অদ্যাবধি
অট্টালিকার  :  অট্টালিকা
অঞ্চলকে  :  অঞ্চলড
অঞ্চলই  :  অঞ্চলই
হুলট্জেককে  :  হুলট্জেকড
হিক্মত  :  হিক্মত
হাসান  :  হাসান
হায়দ্রাবাদ  :  হায়দ্রাবাদ
হাদীসের  :  হাদীস
হাত  :  হাত
হাটহাজারী  :  হাটহাজারী
হাটবাজার  :  হাটবাজা
হাইকোর্ট  :  হাইকোর্ট
হাঁস  :  হাঁস
হাঁড়ের  :  হাঁড়
হলেন  :  হলেন
হলুদ  :  হলুদ
হরিকালদেবের  :  হরিকালদেব
হত্যা  :  হত্যা
স্যান্ডোয়ে  :  স্যান্ডোয়
স্মৃতিসৌধের  :  স্মৃতিসৌধ
স্মৃতিসৌধসমূহ  :  স্মৃতিসৌধসমূহ
স্মিথ  :  স্মিথ
স্বাস্থ্যকেন্দ্র  :  স্বাস্থ্যকেন্দ্
স্বর্ণমুদ্রাটি  :  স্বর্ণমুদ্রা
স্বর্ণমুদ্রা  :  স্বর্ণমুদ্র
স্বতন্ত্র  :  স্বতন্ত্
স্বচ্ছ  :  স্বচ্ছ
স্নাতক  :  স্নাতক
স্থায়ী  :  স্থায়ী
স্থাবর  :  স্থাব
স্থাপনের  :  স্থাপন
স্থাপনার  :  স্থাপনা
স্থাপত্যের  :  স্থাপত্য
স্থাপত্যিক  :  স্থাপত্যিক
স্থাপত্যবিদ্যার  :  স্থাপত্যবিদ্যা
স্থাপত্যবিদ্যা  :  স্থাপত্যবিদ্যা
স্থানান্তরিত  :  স্থানান্তরিত
স্ত্রীলিঙ্গ  :  স্ত্রীলিঙ্গ
স্তূপ  :  স্তূপ
স্তরীভূত  :  স্তরীভূত
স্টেট  :  স্টেট
স্টক  :  স্টক
স্কিমটি  :  স্কিম
সৌন্দর্য  :  সৌন্দর্য
সোসাইটির  :  সোসাই
সেতু  :  সেতু
সেট  :  সেট
সূর্য  :  সূর্য
সূচনা  :  সূচনা
সূচক  :  সূচক
সুসংবদ্ধ  :  সুসংবদ্ধ
সুষ্ঠুভাবে  :  সুষ্ঠুভাব
সুপারিশমালার  :  সুপারিশমালা
সুপারিশমালা  :  সুপারিশমালা
সুপারিনটেন্ডেন্ট  :  সুপারিনটেন্ডেন্ট
সুনির্দিষ্ট  :  সুনির্দিষ্ট
সীমিত  :  সীমিত
সীমান্ত  :  সীমান্ত
সীতাকুন্ডে  :  সীতাকুন্ড
সিল  :  সিল
সিরিজের  :  সিরিজ
সাহায্য  :  সাহায্য
সালিশের  :  সালিশ
সালিশির  :  সালিশি
সালিশ  :  সালিশ
সাম্রাজ্যের  :  সাম্রাজ্য
সামুদ্রিক  :  সামুদ্রিক
সামান্য  :  সামান্য
সামাজিক  :  সামাজিক
সামনের  :  সামন
সামনে  :  সামন
সাভার  :  সাভা
সহায়তায়  :  সহায়তায়
সহায়তা  :  সহায়তা
সর্বশেষ  :  সর্বশেষ
সম্মুখীন  :  সম্মুখীন
সম্মুখ  :  সম্মুখ
সম্বন্ধে  :  সম্বন্ধ
সম্প্রদায়ের  :  সম্প্রদায়
সম্পূর্ণ  :  সম্পূর্ণ
সম্পন্ন  :  সম্পন্ন
সমাপ্ত  :  সমাপ্ত
সমাধি  :  সমাধি
সমন্দর  :  সমন্দ
সবিশেষ  :  সবিশেষ
সন্ধান  :  সন্ধান
সদৃশ  :  সদৃশ
সদস্য  :  সদস্য
সড়ক  :  সড়ক
সঠিক  :  সঠিক
সক্ষম  :  সক্ষম
সংস্থা  :  সংস্থা
সংস্কার  :  সংস্কা
সংরক্ষণে  :  সংরক্ষণ
সংকেতলিপির  :  সংকেতলিপি
সংকুচিত  :  সংকুচিত
শ্রেণির  :  শ্রেণি
শ্রী  :  শ্রী
শেখানো  :  শেখান
শুঙ্গ  :  শুঙ্গ
শিল্পকলা  :  শিল্পকলা
শিক্ষার্থীদের  :  শিক্ষার্থী
শিক্ষাবিদ  :  শিক্ষাবিদ
শি  :  শি
শাহর  :  শাহ
শাস্ত্র  :  শাস্ত্
শাস্তি  :  শাস্তি
শরৎকুমার  :  শরৎকুমা
শর্ত  :  শর্ত
শরফুদ্দীন  :  শরফুদ্দীন
শত  :  শত
শক্তি  :  শক্তি
লোগো  :  লোগ
লিখিত  :  লিখিত
লালমাই  :  লালমাই
লাভের  :  লাভ
লরেন্স  :  লরেন্স
লম্বা  :  লম্বা
লড়হচন্দ্রের  :  লড়হচন্দ্র
লঙ্ঘন  :  লঙ্ঘন
লক্ষণীয়  :  লক্ষণীয়
রোহিঙ্গ্যাদের  :  রোহিঙ্গ্যা
রোয়েদাদের  :  রোয়েদা
রেটিং  :  রেটিং
রেখেছে  :  রেখেছ
রাষ্ট্রের  :  রাষ্ট্র
রাজ্যের  :  রাজ্য
রাজ্য  :  রাজ্য
রাজাদের  :  রাজা
রাজাকারকে  :  রাজাকারড
রাজবংশের  :  রাজবংশ
রাখার  :  রাখা
রয়্যাল  :  রয়্যাল
রমাচন্দ্রনের  :  রমাচন্দ্রন
রমাচন্দ্রন  :  রমাচন্দ্রন
রঙের  :  রঙে
রক্ষা  :  রক্ষা
রংয়ের  :  রংয়
যোগ্যতা  :  যোগ্যতা
যেসব  :  যেসব
যেমনটি  :  যেমন
যুক্তিবিদ্যা  :  যুক্তিবিদ্যা
যুক্তি  :  যুক্তি
যাত্রা  :  যাত্র
যথাক্রমে  :  যথাক্রম
মৌর্যযুগের  :  মৌর্যযুগ
মেলে  :  মেল
মেধ  :  মেধ
মেজর  :  মেজ
মৃৎপাত্রের  :  মৃৎপাত্র
মূলধনের  :  মূলধন
মূলধন  :  মূলধন
মূর্তিটি  :  মূর্তি
মুরগির  :  মুরগি
মুদ্রাটি  :  মুদ্রা
মিটারেরও  :  মিটারেরও
মাস  :  মাস
মার্শালের  :  মার্শাল
মার্শাল  :  মার্শাল
মার্চে  :  মার্চ
মাযার  :  মাযা
মায়ানমারের  :  মায়ানমার
মায়ানমার  :  মায়ানমা
মানুষের  :  মানুষ
মাদ্রাসাদ্বয়  :  মাদ্রাসাদ্বয়
মাথা  :  মাথা
মহিলা  :  মহিলা
মহাস্থানের  :  মহাস্থান
মহাস্থানে  :  মহাস্থান
মহাবিহার  :  মহাবিহা
মস্তকাবরণ  :  মস্তকাবরণ
মন্দিরসমূহের  :  মন্দিরসমূহ
মন্দিরগুলির  :  মন্দিরগুলি
মন্দিরগুলি  :  মন্দিরগুলি
মন্ত্রণালয়াধীন  :  মন্ত্রণালয়াধীন
মনুমেন্টস  :  মনুমেন্টস
মধ্যম  :  মধ্যম
মতে  :  মতে
মঠটির  :  মঠটি
ভৌগোলিক  :  ভৌগোলিক
ভোজ  :  ভোজ
ভাস্কর্যের  :  ভাস্কর্য
ভাস্কর্যসমূহ  :  ভাস্কর্যসমূহ
ভাষ্য  :  ভাষ্য
ভায়না  :  ভায়না
ভাগে  :  ভাগ
ভাগ  :  ভাগ
ভাই  :  ভাই
ভবন  :  ভবন
ভট্টশালী  :  ভট্টশালী
ব্রাহ্মী  :  ব্রাহ্মী
ব্যুরো  :  ব্যুর
ব্যাপকভাবে  :  ব্যাপকভাব
ব্যয়  :  ব্যয়
ব্যবহারের  :  ব্যবহার
ব্যবহারকারী  :  ব্যবহারকারী
ব্যতিত  :  ব্যতিত
ব্যতিক্রম  :  ব্যতিক্রম
বৌদ্ধমূর্তি  :  বৌদ্ধমূর্তি
বোঝাতে  :  বোঝা
বোঝা  :  বোঝা
বৈষ্ণব  :  বৈষ্ণব
বেলায়  :  বেলায়
বুহারে  :  বুহার
বুহার  :  বুহা
বুলার  :  বুলা
বুন্দেলখন্দ  :  বুন্দেলখন্দ
বুদ্ধ  :  বুদ্ধ
বুকানন  :  বুকানন
বিস্তৃতি  :  বিস্তৃতি
বিষ্ণু  :  বিষ্ণু
বিষয়াদি  :  বিষয়াদি
বিষয়গুলি  :  বিষয়গুলি
বিশ্বাস  :  বিশ্বাস
বিশ্বযুদ্ধের  :  বিশ্বযুদ্ধ
বিশ্ববিদ্যলয়  :  বিশ্ববিদ্যলয়
বিশেষভাবে  :  বিশেষভাব
বিশালাকার  :  বিশালাকা
বিলুপ্তপ্রায়  :  বিলুপ্তপ্রায়
বিভাগে  :  বিভাগ
বিভাগকে  :  বিভাগড
বিভক্তির  :  বিভক্তি
বিবরণী  :  বিবরণী
বিপুলসংখ্যক  :  বিপুলসংখ্যক
বিপুল  :  বিপুল
বিদ্যুৎ  :  বিদ্যুৎ
বিচারপতি  :  বিচারপতি
বিকাশমান  :  বিকাশমান
বাস্তব  :  বাস্তব
বাবা  :  বাবা
বাধ্যতামূলক  :  বাধ্যতামূলক
বাণিজ্যসূত্রে  :  বাণিজ্যসূত্র
বাংলাদেশেই  :  বাংলাদেশেই
বস্ত্তত  :  বস্ত্তত
বসবাস  :  বসবাস
বর্মি  :  বর্মি
বদ্বীপ  :  বদ্বীপ
বড়াল  :  বড়াল
বজায়  :  বজায়
বছরগুলোতে  :  বছর
বঙ্গোপসাগরের  :  বঙ্গোপসাগর
বঙ্গের  :  বঙ্গ
বঙ্গীয়  :  বঙ্গীয়
বংশধরদের  :  বংশধর
ফ্লিটের  :  ফ্লিট
ফ্লিটকে  :  ফ্লিটড
ফ্রান্সিস  :  ফ্রান্সিস
ফিক্হশাস্ত্রের  :  ফিক্হশাস্ত্র
ফিক্হ  :  ফিক্হ
ফারসি  :  ফারসি
ফলাফল  :  ফলাফল
ফলকসমূহের  :  ফলকসমূহ
ফলকসমূহ  :  ফলকসমূহ
ফলকগুলির  :  ফলকগুলি
ফল  :  ফল
ফরাসি  :  ফরাসি
প্রিজারভেশন  :  প্রিজারভেশন
প্রাপ্তির  :  প্রাপ্তি
প্রাচীনতম  :  প্রাচীনতম
প্রাকইতিহাস  :  প্রাকইতিহাস
প্রাক  :  প্রাক
প্রস্তর  :  প্রস্ত
প্রশ্ন  :  প্রশ্ন
প্রশাসনিক  :  প্রশাসনিক
প্রযোজ্য  :  প্রযোজ্য
প্রয়োজনীয়  :  প্রয়োজনীয়
প্রয়োগ  :  প্রয়োগ
প্রমাণাদি  :  প্রমাণাদি
প্রবন্ধ  :  প্রবন্ধ
প্রধানত  :  প্রধানত
প্রদেশের  :  প্রদেশ
প্রথাগত  :  প্রথাগত
প্রত্নস্থলটি  :  প্রত্নস্থল
প্রত্নসম্পদ  :  প্রত্নসম্পদ
প্রত্নকীর্তির  :  প্রত্নকীর্তি
প্রত্নকীর্তিকে  :  প্রত্নকীর্তিড
প্রত্নঅঞ্চলের  :  প্রত্নঅঞ্চল
প্রত্নঅঞ্চলসমূহের  :  প্রত্নঅঞ্চলসমূহ
প্রত্নঅঞ্চল  :  প্রত্নঅঞ্চল
প্রত্ন  :  প্রত্ন
প্রতীক  :  প্রতীক
প্রতিষ্ঠানের  :  প্রতিষ্ঠান
প্রতিষ্ঠাতা  :  প্রতিষ্ঠাতা
প্রতিষ্ঠাকাল  :  প্রতিষ্ঠাকাল
প্রতিনিধিত্ব  :  প্রতিনিধিত্ব
প্রণয়ন  :  প্রণয়ন
প্রচেষ্টার  :  প্রচেষ্টা
প্রচেষ্টা  :  প্রচেষ্টা
প্রচারের  :  প্রচার
প্রচার  :  প্রচা
প্রকৃত  :  প্রকৃত
প্রকাশের  :  প্রকাশ
প্রকারের  :  প্রকার
পেশকৃত  :  পেশকৃত
পেতে  :  পেত
পৃষ্ঠপোষকতায়  :  পৃষ্ঠপোষকতায়
পূর্বাঞ্চলে  :  পূর্বাঞ্চল
পূর্বাঞ্চল  :  পূর্বাঞ্চল
পুরুত্বের  :  পুরুত্ব
পুরাকীর্তি  :  পুরাকীর্তি
পুন্ড্রনগরের  :  পুন্ড্রনগর
পুনঃসংস্কার  :  পুনঃসংস্কা
পিএইচ  :  পিএইচ
পাহাড়ের  :  পাহাড়
পালি  :  পালি
পার্বত্য  :  পার্বত্য
পারস্য  :  পারস্য
পারসিক  :  পারসিক
পান্না  :  পান্না
পাত্রের  :  পাত্র
পাঠ্যসূচি  :  পাঠ্যসূচি
পাঠ  :  পাঠ
পাকিস্তানে  :  পাকিস্তান
পাকসেনা  :  পাকসেনা
পাওয়ার  :  পাওয়া
পাওয়ায়  :  পাওয়ায়
পাঁচটি  :  পাঁচ
পাঁচ  :  পাঁচ
পর্যালোচনা  :  পর্যালোচনা
পর্যায়ের  :  পর্যায়
পর্ব  :  পর্ব
পরীক্ষামূলক  :  পরীক্ষামূলক
পরীক্ষা  :  পরীক্ষা
পরিসরে  :  পরিসর
পরিসংখ্যান  :  পরিসংখ্যান
পরিশোধিত  :  পরিশোধিত
পরিমাণে  :  পরিমাণ
পরিভ্রমণ  :  পরিভ্রমণ
পরিবারের  :  পরিবার
পরিবর্তে  :  পরিবর্
পরবর্তীতে  :  পরবর্তী
পদ্ধতির  :  পদ্ধতি
পদের  :  পদে
পদাঙ্ক  :  পদাঙ্ক
পদক্ষেপ  :  পদক্ষেপ
পদও  :  পদও
পথ  :  পথ
পত্রিকা  :  পত্রিকা
পত্র  :  পত্
পতনের  :  পতন
পণ্যদ্রব্যাদি  :  পণ্যদ্রব্যাদি
পড়ে  :  পড়
পঠিত  :  পঠিত
পঠন  :  পঠন
পক্ষগুলি  :  পক্ষগুলি
ন্যায়  :  ন্যায়
নৌকা  :  নৌকা
নেয়ার  :  নেয়া
নেন  :  নেন
নৃতাত্ত্বিক  :  নৃতাত্ত্বিক
নীতি  :  নীতি
নিষ্পত্তির  :  নিষ্পত্তি
নির্দেশনায়  :  নির্দেশনায়
নির্দেশনা  :  নির্দেশনা
নিয়োগে  :  নিয়োগ
নিম্নরূপ  :  নিম্নরূপ
নিবিড়  :  নিবিড়
নিবাস  :  নিবাস
নিদর্শনাদি  :  নিদর্শনাদি
নিচে  :  নিচ
নিকুঞ্জ  :  নিকুঞ্জ
নামের  :  নাম
নামায  :  নামায
নাটশাল  :  নাটশাল
নলকূপের  :  নলকূপ
নরসিংদী  :  নরসিংদী
নবোপলীয়  :  নবোপলীয়
নদী  :  নদী
নওগাঁ  :  নওগাঁ
ধ্বংসাবশেষসমূহ  :  ধ্বংসাবশেষসমূহ
ধীরে  :  ধীর
ধারায়  :  ধারায়
ধারাবাহিকতা  :  ধারাবাহিকতা
ধারাটি  :  ধারা
ধান  :  ধান
ধাতু  :  ধাতু
ধর্মের  :  ধর্ম
ধর্মাবলম্বী  :  ধর্মাবলম্বী
দ্রুত  :  দ্রুত
দেশই  :  দেশই
দেয়ালের  :  দেয়াল
দেয়  :  দেয়
দেওয়ার  :  দেওয়া
দূরবর্তী  :  দূরবর্তী
দীক্ষিতের  :  দীক্ষিত
দিয়েছিলেন  :  দিয়েছিলেন
দায়িত্বভার  :  দায়িত্বভা
দাবি  :  দাবি
দাঁড়ায়  :  দাঁড়ায়
দশকের  :  দশক
দর্শন  :  দর্শন
দমন  :  দমন
থানার  :  থানা
থাকলেও  :  থাকলেও
তৈরির  :  তৈরি
তেরো  :  তের
তুর্ক  :  তুর্ক
তীক্ষ্ণ  :  তীক্ষ্ণ
তাৎপর্যপূর্ণ  :  তাৎপর্যপূর্ণ
তালিকাভুক্ত  :  তালিকাভুক্ত
তালিকা  :  তালিকা
তারিখ  :  তারিখ
তাম্রশাসন  :  তাম্রশাসন
তামবুকিয়াদের  :  তামবুকিয়া
তহবিল  :  তহবিল
তন  :  তন
তখনও  :  তখনও
ত  :  ত
ঢালাই  :  ঢালাই
ডেপুটি  :  ডেপু
ডিসেম্বর  :  ডিসেম্ব
ট্রোভ  :  ট্রোভ
ট্রাইব্যুনালে  :  ট্রাইব্যুনাল
ট্রাইব্যুনাল  :  ট্রাইব্যুনাল
টুকরা  :  টুকর
টাকার  :  টাকা
জ্ঞান  :  জ্ঞান
জেলা  :  জেলা
জেল  :  জেল
জেমস  :  জেমস
জেনারেলের  :  জেনারেল
জীবনের  :  জীবন
জি  :  জি
জার্নালে  :  জার্নাল
জার্নালও  :  জার্নালও
জানুয়ারি  :  জানুয়ারি
জানার  :  জানা
জাদুঘর  :  জাদুঘ
জলস্তরের  :  জলস্তর
জমি  :  জমি
জনসংখ্যা  :  জনসংখ্যা
জনগোষ্ঠীর  :  জনগোষ্ঠী
জনগণের  :  জনগণ
জটার  :  জটা
ছোট্ট  :  ছোট্ট
চুক্তিতে  :  চুক্তি
চুক্তি  :  চুক্তি
চীনের  :  চীন
চিহ্নিতকরণ  :  চিহ্নিতকরণ
চাকা  :  চাকা
চাকরির  :  চাকরি
চর্চায়  :  চর্চায়
চট্টগ্রামের  :  চট্টগ্রাম
চট্টগ্রামে  :  চট্টগ্রাম
চওড়া  :  চওড়া
ঘর  :  ঘর
ঘটনা  :  ঘটনা
গ্রামের  :  গ্রাম
গ্রাম  :  গ্রাম
গ্রন্থের  :  গ্রন্থ
গোইং  :  গোইং
গুলোর  :  গুল
গুলো  :  গুল
গুরাবা  :  গুরাবা
গুপ্তধন  :  গুপ্তধন
গাড়িতে  :  গাড়ি
গভর্নর  :  গভর্ন
গবেষণামূলক  :  গবেষণামূলক
গবাদিপশু  :  গবাদিপশু
গণপূর্ত  :  গণপূর্ত
গঠনের  :  গঠন
গ  :  গ
খ্রিস্টাব্দের  :  খ্রিস্টাব্
খুবই  :  খুবই
খুব  :  খুব
খামার  :  খামা
খানকাহ  :  খানকাহ
খলিফাদের  :  খলিফা
খলিফা  :  খলিফা
খন্ড  :  খন্ড
খননের  :  খনন
খড়গ  :  খড়গ
খ  :  খ
ক্ষেত্রেও  :  ক্ষেত্রেও
ক্ষমতার  :  ক্ষমতা
ক্রেডিট  :  ক্রেডিট
ক্রুশাকৃতির  :  ক্রুশাকৃতি
ক্রিয়াপদ  :  ক্রিয়াপদ
কোনটি  :  কোন
কেনো  :  কেন
কেন  :  কেন
কিছুকাল  :  কিছুকাল
কিউরেটর  :  কিউরেট
কার্যক্রমের  :  কার্যক্রম
কার্নেলিয়ান  :  কার্নেলিয়ান
কামরূপ  :  কামরূপ
কাঠে  :  কাঠ
কাঠামো  :  কাঠাম
কাঁচের  :  কাঁচ
কলেজ  :  কলেজ
কলকাতায়  :  কলকাতায়
কর্মরত  :  কর্মরত
করতেন  :  করতেন
কমিটির  :  কমি
কবি  :  কবি
কথাও  :  কথাও
ক  :  ক
এ্যানুয়াল  :  এ্যানুয়াল
এশিয়ার  :  এশিয়া
এরপর  :  এরপ
এভাবেই  :  এভাবেই
এভাবে  :  এভাব
এপ্রিল  :  এপ্রিল
এক্সচেঞ্জ  :  এক্সচেঞ্জ
একেবারে  :  একেবার
একীভূত  :  একীভূত
একাধিক  :  একাধিক
একশ  :  একশ
একটা  :  একটা
এককটির  :  একক
ঋণ  :  ঋণ
উৎস  :  উৎস
উৎপাদিত  :  উৎপাদিত
উৎপন্ন  :  উৎপন্ন
উৎপত্তি  :  উৎপত্তি
উৎখননকৃত  :  উৎখননকৃত
উল  :  উল
উপরিভাগে  :  উপরিভাগ
উপজেলার  :  উপজেলা
উপজেলা  :  উপজেলা
উপকূল  :  উপকূল
উদ্ভবের  :  উদ্ভব
উত্তীর্ণ  :  উত্তীর্ণ
উঠে  :  উঠে
উচ্চমানের  :  উচ্চমান
উক্ত  :  উক্ত
ইম্পেরিয়াল  :  ইম্পেরিয়াল
ইমাম  :  ইমাম
ইন্দো  :  ইন্দ
ইন্ডিয়ান  :  ইন্ডিয়ান
ইন্টারমিডিয়েট  :  ইন্টারমিডিয়েট
ইত্যাদির  :  ইত্যাদি
ইটের  :  ইটে
ইট  :  ইট
ইউনিয়ন  :  ইউনিয়ন
ইউনিট  :  ইউনিট
ইংরেজ  :  ইংরেজ
আহমদ  :  আহমদ
আসা  :  আসা
আসছে  :  আসছ
আশ্চর্য  :  আশ্চর্য
আশরাফ  :  আশরাফ
আলোচিত  :  আলোচিত
আলোচনায়  :  আলোচনায়
আলোচনা  :  আলোচনা
আলীয়া  :  আলীয়া
আর্কিওলোজিক্যাল  :  আর্কিওলোজিক্যাল
আরেকটি  :  আরেক
আরাকানিরাই  :  আরাকানিরাই
আরাকানিদের  :  আরাকা
আরবির  :  আরবি
আরতির  :  আরতি
আমেরিকান  :  আমেরিকান
আবিষ্কারসমূহ  :  আবিষ্কারসমূহ
আপীল  :  আপীল
আনু  :  আনু
আদালতের  :  আদালত
আদমশুমারি  :  আদমশুমারি
আটঘরা  :  আটঘর
আঞ্চলিক  :  আঞ্চলিক
আজমির  :  আজমি
আজও  :  আজও
আগমন  :  আগমন
আকিক  :  আকিক
আকারে  :  আকার
আওতায়  :  আওতায়
আওতাধীন  :  আওতাধীন
আইনটিতে  :  আইন
আংশিক  :  আংশিক
অস্বীকৃতি  :  অস্বীকৃতি
অলঙ্কৃত  :  অলঙ্কৃত
অলংকারশাস্ত্র  :  অলংকারশাস্ত্
অর্থোদ্ধার  :  অর্থোদ্ধা
অর্জন  :  অর্জন
অর  :  অর
অভিলেখন  :  অভিলেখন
অভিযোগ  :  অভিযোগ
অবস্থান  :  অবস্থান
অবস্থা  :  অবস্থা
অবসর  :  অবস
অবশ্যই  :  অবশ্যই
অবশিষ্ট  :  অবশিষ্ট
অবলুপ্তি  :  অবলুপ্তি
অপর  :  অপর
অন্তর্গত  :  অন্তর্গত
অনুসৃত  :  অনুসৃত
অনুসারে  :  অনুসার
অনুসন্ধানের  :  অনুসন্ধান
অনুমোদিত  :  অনুমোদিত
অনুপ্রবেশ  :  অনুপ্রবেশ
অনুধাবন  :  অনুধাবন
অনন্য  :  অনন্য
অধ্যয়ন  :  অধ্যয়ন
অধিষ্ঠিত  :  অধিষ্ঠিত
অধিদপ্তরের  :  অধিদপ্তর
অধিকার  :  অধিকা
অতীতে  :  অতী
অতীত  :  অতীত
অতিক্রম  :  অতিক্রম
অঞ্চলসমূহের  :  অঞ্চলসমূহ
অজানা  :  অজানা
অগ্রগণ্য  :  অগ্রগণ্য
অংশের  :  অংশ
হ্রাস  :  হ্রাস
হোসেনের  :  হোসেন
হেস্টিংস  :  হেস্টিংস
হেনরি  :  হেনরি
হুলটজেককে  :  হুলটজেকড
হুমকির  :  হুমকি
হুজ্জাত  :  হুজ্জাত
হিসাব  :  হিসাব
হিন্দুদের  :  হিন্দু
হিন্দি  :  হিন্দি
হিদায়তুন  :  হিদায়তুন
হাসপাতাল  :  হাসপাতাল
হালাল  :  হালাল
হাল  :  হাল
হার্ন্ডিজ  :  হার্ন্ডিজ
হারুন  :  হারুন
হারিরি  :  হারিরি
হারিয়ে  :  হারিয়
হারাম  :  হারাম
হায়দ্রাবাদসহ  :  হায়দ্রাবাদসহ
হাম্দ  :  হাম্দ
হামযা  :  হামযা
হাবিবুল্লাহ  :  হাবিবুল্লাহ
হানিফ  :  হানিফ
হাদীসে  :  হাদীস
হাদীসই  :  হাদীসই
হাদী  :  হাদী
হাদিপুর  :  হাদিপু
হাতির  :  হাতি
হাতিয়ারসমূহের  :  হাতিয়ারসমূহ
হাতি  :  হাতি
হাতল  :  হাতল
হাওদুল  :  হাওদুল
হাওড়া  :  হাওড়া
হাইজাদিতে  :  হাইজাদি
হাঁড়  :  হাঁড়
হস্তনির্মিত  :  হস্তনির্মিত
হস্তক্ষেপ  :  হস্তক্ষেপ
হরোয়া  :  হরোয়া
হরিনারায়ণপুরের  :  হরিনারায়ণপুর
হরিকেল  :  হরিকেল
হয়েছিলেন  :  হয়েছিলেন
হয়াত  :  হয়াত
হযরত  :  হযরত
হদিস  :  হদিস
হঠাৎ  :  হঠাৎ
হজ্জ  :  হজ্জ
হক  :  হক
স্মৃতিসৌধসমূহের  :  স্মৃতিসৌধসমূহ
স্মৃতিসৌধসমূহকে  :  স্মৃতিসৌধসমূহড
স্মৃতিসৌধগুলোকে  :  স্মৃতিসৌধগুলোড
স্মারকের  :  স্মারক
স্বাস্থ্যকর  :  স্বাস্থ্যক
স্বাস্থ্য  :  স্বাস্থ্য
স্বার্থসংশ্লিষ্ট  :  স্বার্থসংশ্লিষ্ট
স্বামী  :  স্বামী
স্বল্পমেয়াদি  :  স্বল্পমেয়াদি
স্বর্ণের  :  স্বর্ণ
স্বর্ণশিল্প  :  স্বর্ণশিল্প
স্বর্ণযুগ  :  স্বর্ণযুগ
স্বরবর্ণ  :  স্বরবর্ণ
স্বতন্ত্রভাগে  :  স্বতন্ত্রভাগ
স্ফটিক  :  স্ফটিক
স্প্যানিশ  :  স্প্যানিশ
স্পষ্টত  :  স্পষ্টত
স্থায়ীভাবে  :  স্থায়ীভাব
স্থায়ীত্বের  :  স্থায়ীত্ব
স্থাপনাসমূহের  :  স্থাপনাসমূহ
স্থাপনকারীরা  :  স্থাপনকারীর
স্থাপত্যটির  :  স্থাপত্য
স্থাপত্যকলার  :  স্থাপত্যকলা
স্থাপত্যকর্মের  :  স্থাপত্যকর্ম
স্থাপত্যকর্মটির  :  স্থাপত্যকর্ম
স্থাপত্যও  :  স্থাপত্যও
স্থানীয়ভাবে  :  স্থানীয়ভাব
স্থানগুলি  :  স্থানগুলি
স্থলগুলির  :  স্থলগুলি
স্থপতি  :  স্থপতি
স্তোত্রাদি  :  স্তোত্রাদি
স্তূপের  :  স্তূপ
স্তূপসমূহের  :  স্তূপসমূহ
স্তূপগুলি  :  স্তূপগুলি
স্তরের  :  স্তর
স্তরবিন্যাস  :  স্তরবিন্যাস
স্তরকে  :  স্তরড
স্তম্ভ  :  স্তম্ভ
স্টেটের  :  স্টেট
স্টাফোর্ডের  :  স্টাফোর্ড
স্টাডিজ  :  স্টাডিজ
স্কুলের  :  স্কুল
স্কিমের  :  স্কিম
স্কিম  :  স্কিম
সৌন্দর্যে  :  সৌন্দর্য
সোহরাওয়ার্দী  :  সোহরাওয়ার্দী
সোরাহীর  :  সোরাহী
সোরাহী  :  সোরাহী
সোয়া  :  সোয়া
সোমপুরে  :  সোমপুর
সোনারগাঁও  :  সোনারগাঁও
সোনার  :  সোনা
সৈয়দ  :  সৈয়দ
সেসব  :  সেসব
সেসকল  :  সেসকল
সেমিটিক  :  সেমিটিক
সেভাবেই  :  সেভাবেই
সেবার  :  সেবা
সেপ্টেম্বর  :  সেপ্টেম্ব
সেনাবাহিনীতে  :  সেনাবাহিনী
সেগুলো  :  সেগুল
সেগুলির  :  সেগুলি
সেখানকার  :  সেখানকা
সেক্টরের  :  সেক্টর
সৃষ্ট  :  সৃষ্ট
সূত্রপাত  :  সূত্রপাত
সূত্র  :  সূত্
সূতপ  :  সূতপ
সূচিত  :  সূচিত
সুস্পষ্টভাবে  :  সুস্পষ্টভাব
সুস্পষ্ট  :  সুস্পষ্ট
সুসজ্জিত  :  সুসজ্জিত
সুশৃঙ্খল  :  সুশৃঙ্খল
সুলায়মান  :  সুলায়মান
সুরাহা  :  সুরাহা
সুরতন  :  সুরতন
সুরক্ষিত  :  সুরক্ষিত
সুফিদের  :  সুফি
সুফিতত্ত্ব  :  সুফিতত্ত্ব
সুপ্রিম  :  সুপ্রিম
সুপ্রসিদ্ধ  :  সুপ্রসিদ্ধ
সুপ্রতিষ্ঠিত  :  সুপ্রতিষ্ঠিত
সুপারিশের  :  সুপারিশ
সুপারিন্টিডেন্ট  :  সুপারিন্টিডেন্ট
সুপরিকল্পিতভাবে  :  সুপরিকল্পিতভাব
সুন্নত  :  সুন্নত
সুন্দর  :  সুন্দ
সুদৃশ্য  :  সুদৃশ্য
সুদূর  :  সুদূ
সুদীর্ঘ  :  সুদীর্ঘ
সুতরাং  :  সুতরাং
সুজার  :  সুজা
সুজা  :  সুজা
সুখ্যাতি  :  সুখ্যাতি
সুওয়াম  :  সুওয়াম
সীমাবদ্ধ  :  সীমাবদ্ধ
সীতাকোটের  :  সীতাকোট
সিহালভী  :  সিহালভী
সিলেট  :  সিলেট
সিলমোহরের  :  সিলমোহর
সিলমোহরে  :  সিলমোহর
সিন্ধুসভ্যতা  :  সিন্ধুসভ্যতা
সিন্ধুর  :  সিন্ধু
সিন্ধুতে  :  সিন্ধু
সিন্ডিকেটেড  :  সিন্ডিকেটেড
সিটটয়ে  :  সিটটয়
সিঙ্গার  :  সিঙ্গা
সিক্রি  :  সিক্রি
সিকান্দারাবাদের  :  সিকান্দারাবা
সিংহাসনে  :  সিংহাসন
সিংহাসন  :  সিংহাসন
সাহিত্যকে  :  সাহিত্যড
সাহায্যেই  :  সাহায্যেই
সাহসী  :  সাহসী
সাসানিদ  :  সাসানিদ
সালেউৎখনন  :  সালেউৎখনন
সালিশীর  :  সালিশী
সালিশী  :  সালিশী
সালিশকারীদের  :  সালিশকারী
সালিশকারীকে  :  সালিশকারীড
সার্ভেয়রকে  :  সার্ভেয়রড
সার্ভেয়র  :  সার্ভেয়
সার্কেল  :  সার্কেল
সারিতে  :  সারি
সাম্প্রতিককালের  :  সাম্প্রতিককাল
সামি  :  সামি
সামারকান্দীর  :  সামারকান্দী
সামরিক  :  সামরিক
সাময়িক  :  সাময়িক
সামগ্রীর  :  সামগ্রী
সাফল্য  :  সাফল্য
সান  :  সান
সাধকরা  :  সাধকর
সাধকদের  :  সাধক
সাধকগণ  :  সাধকগণ
সাধক  :  সাধক
সাদাসর্দি  :  সাদাসর্দি
সাওঘাটে  :  সাওঘাট
সাইটিক  :  সাইটিক
সাংস্কৃতিকভাবে  :  সাংস্কৃতিকভাব
সাঁটা  :  সাঁটা
সহায়তাদানের  :  সহায়তাদান
সহায়ক  :  সহায়ক
সহস্রাধিক  :  সহস্রাধিক
সহযোগী  :  সহযোগী
সহযোগিতায়  :  সহযোগিতায়
সহনীয়  :  সহনীয়
সহজ  :  সহজ
সহকারে  :  সহকার
সহকারীসহ  :  সহকারীসহ
সহকারীদের  :  সহকারী
সহ  :  সহ
সষ্টি  :  সষ্
সর্বোতভদ্র  :  সর্বোতভদ্
সর্বমোট  :  সর্বমোট
সর্বপ্রথম  :  সর্বপ্রথম
সর্বত্র  :  সর্বত্
সর্বক্ষেত্রে  :  সর্বক্ষেত্র
সরিষাদহ  :  সরিষাদহ
সরিষা  :  সরিষা
সরবরাহে  :  সরবরাহ
সরকারী  :  সরকারী
সরকারগুলোকে  :  সরকারগুলোড
সম্রাটের  :  সম্রাট
সম্মিলিতভাবে  :  সম্মিলিতভাব
সম্মানিত  :  সম্মানিত
সম্মতিক্রমে  :  সম্মতিক্রম
সম্মত  :  সম্মত
সম্ভ্রান্ত  :  সম্ভ্রান্ত
সম্ভাব্য  :  সম্ভাব্য
সম্বদ্ধে  :  সম্বদ্ধ
সম্প্রদায়  :  সম্প্রদায়
সম্পূর্ণরূপে  :  সম্পূর্ণরূপ
সম্পূর্ণভাবে  :  সম্পূর্ণভাব
সম্পূর্ণতা  :  সম্পূর্ণতা
সম্পদ  :  সম্পদ
সম্পত্তি  :  সম্পত্তি
সমৃদ্ধিশালী  :  সমৃদ্ধিশালী
সমৃদ্ধির  :  সমৃদ্ধি
সমৃদ্ধি  :  সমৃদ্ধি
সমৃদ্ধ  :  সমৃদ্ধ
সমূহকে  :  সমূহড
সমূহও  :  সমূহও
সমুদ্রে  :  সমুদ্র
সমুদ্রগামী  :  সমুদ্রগামী
সমীক্ষা  :  সমীক্ষা
সমাহিত  :  সমাহিত
সমাহার  :  সমাহা
সমার্থক  :  সমার্থক
সমান  :  সমান
সমাধিস্ত  :  সমাধিস্ত
সমাজের  :  সমাজ
সমস্যার  :  সমস্যা
সমস্যা  :  সমস্যা
সমসংখ্যক  :  সমসংখ্যক
সমর্থন  :  সমর্থন
সমর্থকদের  :  সমর্থক
সমন্বিত  :  সমন্বিত
সমন্বয়ে  :  সমন্বয়
সমন্বয়  :  সমন্বয়
সমতুল্য  :  সমতুল্য
সমতল  :  সমতল
সমতট  :  সমতট
সমজাতীয়  :  সমজাতীয়
সবগুলিতেই  :  সবগুলিতেই
সপ্তম  :  সপ্তম
সপরিবারে  :  সপরিবার
সন্নিকটে  :  সন্নিকট
সন্ধ্যায়  :  সন্ধ্যায়
সন্দ্বীপে  :  সন্দ্বীপ
সন্দ্বীপ  :  সন্দ্বীপ
সনাতন  :  সনাতন
সদ্রুদ্দীনের  :  সদ্রুদ্দীন
সদ্য  :  সদ্য
সদস্যের  :  সদস্য
সঠিকভাবে  :  সঠিকভাব
সঞ্চালন  :  সঞ্চালন
সঞ্চার  :  সঞ্চা
সঞ্চয়  :  সঞ্চয়
সজ্জিত  :  সজ্জিত
সচিত্র  :  সচিত্
সঙ্গেই  :  সঙ্গেই
সঙ্গীতবিদ্যা  :  সঙ্গীতবিদ্যা
সঙ্গমস্থলের  :  সঙ্গমস্থল
সঙ্গত  :  সঙ্গত
সংস্কৃতি  :  সংস্কৃতি
সংস্কারই  :  সংস্কারই
সংসদের  :  সংস
সংসদ  :  সংসদ
সংশোধনের  :  সংশোধন
সংশোধনীসমূহ  :  সংশোধনীসমূহ
সংলগ্ন  :  সংলগ্ন
সংরক্ষণেরই  :  সংরক্ষণেরই
সংরক্ষণেও  :  সংরক্ষণেও
সংযোজন  :  সংযোজন
সংযোগকে  :  সংযোগড
সংযোগ  :  সংযোগ
সংমিশ্রণ  :  সংমিশ্রণ
সংঘটিত  :  সংঘটিত
সংঘটন  :  সংঘটন
সংগঠনের  :  সংগঠন
সংখ্যার  :  সংখ্যা
সংখ্যায়  :  সংখ্যায়
সংখ্যাও  :  সংখ্যাও
সংক্ষিপ্ত  :  সংক্ষিপ্ত
সংকলন  :  সংকলন
ষোল  :  ষোল
ষাটের  :  ষাট
শ্রেণিসমূহে  :  শ্রেণিসমূহ
শ্রেণিতে  :  শ্রেণি
শ্রেণিও  :  শ্রেণিও
শ্রমে  :  শ্রম
শ্রমিকের  :  শ্রমিক
শ্রমিকদের  :  শ্রমিক
শোনা  :  শোনা
শৈলীতে  :  শৈলী
শেষভাগের  :  শেষভাগ
শেখার  :  শেখা
শুদ্ধ  :  শুদ্ধ
শীতলপাটি  :  শীতলপা
শিশুর  :  শিশু
শিশু  :  শিশু
শিল্পের  :  শিল্প
শিল্পকর্মের  :  শিল্পকর্ম
শিল্পকর্ম  :  শিল্পকর্ম
শিলাস্তর  :  শিলাস্ত
শিলালিপিতে  :  শিলালিপি
শিলা  :  শিলা
শিরোনাম  :  শিরোনাম
শিবমন্দির  :  শিবমন্দি
শিখে  :  শিখ
শিখর  :  শিখ
শিক্ষিত  :  শিক্ষিত
শিক্ষালয়  :  শিক্ষালয়
শিক্ষার্থীদেরকেও  :  শিক্ষার্থীদেরকেও
শিক্ষায়  :  শিক্ষায়
শিক্ষাব্যবস্থা  :  শিক্ষাব্যবস্থা
শিক্ষাবর্ষে  :  শিক্ষাবর্ষ
শিক্ষাদানের  :  শিক্ষাদান
শিক্ষাক্রম  :  শিক্ষাক্রম
শিক্ষাকে  :  শিক্ষাড
শিক্ষাও  :  শিক্ষাও
শিক্ষক  :  শিক্ষক
শাহের  :  শাহ
শাহেথ  :  শাহেথ
শাহবাজপুর  :  শাহবাজপু
শাস্তির  :  শাস্তি
শাসনে  :  শাসন
শাসনকাল  :  শাসনকাল
শাসনকার্য  :  শাসনকার্য
শাসনকর্তা  :  শাসনকর্তা
শালবনবিহারের  :  শালবনবিহার
শারীরিক  :  শারীরিক
শারকি  :  শারকি
শাম্স  :  শাম্স
শামসুল  :  শামসুল
শান্তিপ্রয়াসী  :  শান্তিপ্রয়াসী
শান্তিপূর্ণ  :  শান্তিপূর্ণ
শান্তি  :  শান্তি
শানপুকুর  :  শানপুকু
শাড়ি  :  শাড়ি
শাখায়  :  শাখায়
শাখাতেই  :  শাখাতেই
শাখাটির  :  শাখা
শাকসবজি  :  শাকসবজি
শাঁখ  :  শাঁখ
শহরে  :  শহর
শহরতলি  :  শহরতলি
শস্যকর্তনরত  :  শস্যকর্তনরত
শলাকা  :  শলাকা
শর্মী  :  শর্মী
শর্তানুযায়ী  :  শর্তানুযায়ী
শরীফেরও  :  শরীফেরও
শরীফের  :  শরীফ
শরণার্থী  :  শরণার্থী
শব্দলজাত  :  শব্দলজাত
শব্দদ্বয়  :  শব্দদ্বয়
শব্দটির  :  শব্দ
শফির  :  শফি
শতাব্দীর  :  শতাব্দী
শতাধিক  :  শতাধিক
শঙ্খ  :  শঙ্খ
শক্তিশালী  :  শক্তিশালী
শ  :  শ
লৌহশিল্প  :  লৌহশিল্প
লোকেরা  :  লোক
লোক  :  লোক
লেফটেন্যান্ট  :  লেফটেন্যান্ট
লেউর  :  লেউ
লুকিয়ে  :  লুকিয়
লিপিসমূহে  :  লিপিসমূহ
লিপিরই  :  লিপিরই
লিপিভাষ্য  :  লিপিভাষ্য
লিপিকারক  :  লিপিকারক
লিটন  :  লিটন
লিচু  :  লিচু
লিঙ্গ  :  লিঙ্গ
লিখেছেন  :  লিখেছেন
লিখেছিলেন  :  লিখেছিলেন
লিখনপদ্ধতি  :  লিখনপদ্ধতি
লিখন  :  লিখন
লিখতে  :  লিখ
লিওনার্ড  :  লিওনার্ড
লালবাগ  :  লালবাগ
লাববাইক  :  লাববাইক
লাববাই  :  লাববাই
লাগানো  :  লাগান
লস্কর  :  লস্ক
ললিতপুর  :  ললিতপু
লম্বাকৃতির  :  লম্বাকৃতি
লতার  :  লতা
লড়াইয়ে  :  লড়াইয়
লড়াই  :  লড়াই
লঙ্ঘনে  :  লঙ্ঘন
লক্ষ্ণৌর  :  লক্ষ্ণৌ
লক্ষিন্দরের  :  লক্ষিন্দর
লক্ষণসেনের  :  লক্ষণসেন
লক্ষ  :  লক্ষ
ল  :  ল
র্চ্চার  :  র্চ্চা
রৌপ্যের  :  রৌপ্য
রোহিঙ্গ্যারা  :  রোহিঙ্গ্যার
রোয়োদাদ  :  রোয়োদাদ
রোমান  :  রোমান
রোমাঞ্চকর  :  রোমাঞ্চক
রোপণের  :  রোপণ
রেমিটেন্স  :  রেমিটেন্স
রেজিস্ট্রারে  :  রেজিস্ট্রার
রেজিস্ট্রার  :  রেজিস্ট্রা
রেগুলেশনের  :  রেগুলেশন
রেখেছেন  :  রেখেছেন
রেখেছিল  :  রেখেছিল
রেখেই  :  রেখেই
রেকর্ড  :  রেকর্ড
রূপে  :  রূপ
রূপান্তর  :  রূপান্ত
রূপই  :  রূপই
রূপ  :  রূপ
রুলেট  :  রুলেট
রুলস  :  রুলস
রুমুয  :  রুমুয
রুমী  :  রুমী
রুপির  :  রুপি
রুপি  :  রুপি
রুকনউদ্দীন  :  রুকনউদ্দীন
রীতিতে  :  রীতি
রীতিও  :  রীতিও
রিপোর্টস  :  রিপোর্টস
রিপোর্টগুলির  :  রিপোর্টগুলি
রিপনের  :  রিপন
রিজার্ভ  :  রিজার্ভ
রি  :  রি
রাষ্ট্রভাষা  :  রাষ্ট্রভাষা
রাষ্ট্র  :  রাষ্ট্
রায়ের  :  রায়
রায়দিঘি  :  রায়দিঘি
রামায়ণের  :  রামায়ণ
রামমোহন  :  রামমোহন
রামপালে  :  রামপাল
রামচরিতম্  :  রামচরিতম্
রানীর  :  রানী
রাধানগর  :  রাধানগ
রাঢ়  :  রাঢ়
রাজ্যটিকে  :  রাজ্যটিড
রাজ্যকে  :  রাজ্যড
রাজ্যও  :  রাজ্যও
রাজী  :  রাজী
রাজারা  :  রাজার
রাজাকে  :  রাজাড
রাজসভায়  :  রাজসভায়
রাজশাহীতে  :  রাজশাহী
রাজবংশ  :  রাজবংশ
রাজপুতনাসহ  :  রাজপুতনাসহ
রাজনৈতিকভাবেও  :  রাজনৈতিকভাবেও
রাজত্ব  :  রাজত্ব
রাজক্ষমতা  :  রাজক্ষমতা
রাখাইনপিয়ে  :  রাখাইনপিয়
রাখাইন  :  রাখাইন
রাক্ষস  :  রাক্ষস
রাইস  :  রাইস
রাইফেলসহ  :  রাইফেলসহ
রসকে  :  রসক
রশিদের  :  রশি
রশিদ  :  রশিদ
রয়ে  :  রয়
রমাপ্রসাদ  :  রমাপ্রসাদ
রমরী  :  রমরী
রপ্তানিদ্রব্য  :  রপ্তানিদ্রব্য
রদবদল  :  রদবদল
রণবঙ্কমল্ল  :  রণবঙ্কমল্ল
রজারসের  :  রজারস
রজব  :  রজব
রঙ্গীন  :  রঙ্গীন
রক্ষার্থে  :  রক্ষার্থ
রক্ষার  :  রক্ষা
রক্ষণাবেক্ষণে  :  রক্ষণাবেক্ষণ
রক্তক্ষয়ী  :  রক্তক্ষয়ী
রংপুর  :  রংপু
যোগী  :  যোগী
যোগশাস্ত্রের  :  যোগশাস্ত্র
যোগ  :  যোগ
যেভাবে  :  যেভাব
যেত  :  যেত
যেটির  :  যেটি
যেগুলো  :  যেগুল
যেগুলির  :  যেগুলি
যেগুলি  :  যেগুলি
যুদ্ধে  :  যুদ্ধ
যুদ্ধমন্ত্রী  :  যুদ্ধমন্ত্রী
যুদ্ধ  :  যুদ্ধ
যুগ্ম  :  যুগ্ম
যুগোপযোগী  :  যুগোপযোগী
যুগান্তকারী  :  যুগান্তকারী
যুগল  :  যুগল
যুগ  :  যুগ
যুক্তরাজ্যের  :  যুক্তরাজ্য
যিয়াফত  :  যিয়াফত
যায়নি  :  যায়
যাবতীয়  :  যাবতীয়
যাত্রাবাড়ী  :  যাত্রাবাড়ী
যাতায়াত  :  যাতায়াত
যাচ্ছে  :  যাচ্ছ
যাচাই  :  যাচাই
যাকাত  :  যাকাত
যাক  :  যাক
যাওয়ার  :  যাওয়া
যাওয়ায়  :  যাওয়ায়
যাইহোক  :  যাইহোক
যন্ত্রপাতি  :  যন্ত্রপাতি
যথেচ্ছাভাবে  :  যথেচ্ছাভাব
যথার্থভাবে  :  যথার্থভাব
যথার্থ  :  যথার্থ
যথারীতি  :  যথারীতি
যত্নের  :  যত্ন
যখেরডাঙ্গা  :  যখেরডাঙ্গা
যক্ষ  :  যক্ষ
মৎস্য  :  মৎস্য
ম্রোহং  :  ম্রোহং
ম্যাক্সমুলারের  :  ম্যাক্সমুলার
মৌসুমে  :  মৌসুম
মৌসুম  :  মৌসুম
মৌর্যরীতির  :  মৌর্যরীতি
মোহনা  :  মোহনা
মোস্তাকিমবিল্লাহ্  :  মোস্তাকিমবিল্লাহ্
মোল্লা  :  মোল্লা
মোটের  :  মোট
মোটা  :  মোটা
মোচপোল  :  মোচপোল
মোগলরাও  :  মোগলরাও
মোকাম্মেল  :  মোকাম্মেল
মোকাবেলা  :  মোকাবেলা
মৈত্রেয়  :  মৈত্রেয়
মেলা  :  মেলা
মেয়াদকাল  :  মেয়াদকাল
মেয়াদ  :  মেয়াদ
মেধার  :  মেধা
মেধাবী  :  মেধাবী
মেগালিথিক  :  মেগালিথিক
মৃৎপাত্রগুলিতে  :  মৃৎপাত্রগুলি
মৃত্যুর  :  মৃত্যু
মূললক্ষ্য  :  মূললক্ষ্য
মূর্তিগুলির  :  মূর্তিগুলি
মূর্তিগুলি  :  মূর্তিগুলি
মূর্তিও  :  মূর্তিও
মুহ্সিনিয়া  :  মুহ্সিনিয়া
মুহম্মদ  :  মুহম্মদ
মুসলিমগণ  :  মুসলিমগণ
মুলক  :  মুলক
মুরতাদ  :  মুরতাদ
মুযারি  :  মুযারি
মুয়ং  :  মুয়ং
মুনশী  :  মুনশী
মুদ্রা্  :  মুদ্রা্
মুদ্রাসমূহের  :  মুদ্রাসমূহ
মুদ্রালিপি  :  মুদ্রালিপি
মুদ্রার  :  মুদ্রা
মুদ্রাতত্ত্ববিদ  :  মুদ্রাতত্ত্ববিদ
মুদ্রাও  :  মুদ্রাও
মুতানাবিব  :  মুতানাবিব
মুড়াটি  :  মুড়া
মুগলদের  :  মুগল
মুখোপাধ্যায়  :  মুখোপাধ্যায়
মুখের  :  মুখ
মুখে  :  মুখ
মুক্তিযুদ্ধের  :  মুক্তিযুদ্ধ
মুক্তিদ্ধোদের  :  মুক্তিদ্ধ
মুওয়াহ্হিদীন  :  মুওয়াহ্হিদীন
মুইন  :  মুইন
মীযান  :  মীযান
মীন  :  মীন
মিহিরের  :  মিহির
মিশ্রিত  :  মিশ্রিত
মিশ্রণ  :  মিশ্রণ
মিশেছে  :  মিশেছ
মিশকাত  :  মিশকাত
মিলে  :  মিল
মির্যা  :  মির্যা
মিরাছ  :  মিরাছ
মিটিয়ে  :  মিটিয়
মিছিলের  :  মিছিল
মি  :  মি
মাহেথ  :  মাহেথ
মাহীসুনের  :  মাহীসুন
মাহিসওয়ার  :  মাহিসওয়া
মালিকানাধীন  :  মালিকানাধীন
মালিককে  :  মালিকড
মালিক  :  মালিক
মালা  :  মালা
মালয়  :  মালয়
মালওয়া  :  মালওয়া
মার্শালকে  :  মার্শালড
মার্চ  :  মার্চ
মার্কুইস  :  মার্কুইস
মাযি  :  মাযি
মামুন  :  মামুন
মানেরী  :  মানেরী
মানুষেরা  :  মানুষ
মানুষ  :  মানুষ
মানবাধিকারও  :  মানবাধিকারও
মানচিত্রের  :  মানচিত্র
মানচিত্রসহ  :  মানচিত্রসহ
মান  :  মান
মাধ্যমিক  :  মাধ্যমিক
মাদ্রাসায়ও  :  মাদ্রাসায়ও
মাদ্রাসায়  :  মাদ্রাসায়
মাদ্রাসাটি  :  মাদ্রাসা
মাদ্রাজেই  :  মাদ্রাজেই
মাথায়  :  মাথায়
মাথাটি  :  মাথা
মাত্রার  :  মাত্রা
মাঠপর্যায়ে  :  মাঠপর্যায়
মাঠ  :  মাঠ
মাটি  :  মাটি
মাঝামাঝি  :  মাঝামাঝি
মাইলের  :  মাইল
মাইলব্যাপী  :  মাইলব্যাপী
মাইয়ু  :  মাইয়ু
মহীশুর  :  মহীশু
মহাস্থানগড়েও  :  মহাস্থানগড়েও
মহাস্থানগড়ে  :  মহাস্থানগড়
মহাস্থানগড়কে  :  মহাস্থানগড়ড
মহাবালিপুরম  :  মহাবালিপুরম
মস্তকাবরণী  :  মস্তকাবরণী
মস্তকবিহীন  :  মস্তকবিহীন
মসজিদের  :  মসজি
মর্যাদায়  :  মর্যাদায়
মর্যাদা  :  মর্যাদা
মরিসন  :  মরিসন
ময়মনসিংহের  :  ময়মনসিংহ
ময়মনসিংহ  :  ময়মনসিংহ
ময়নামতি  :  ময়নামতি
মমিন  :  মমিন
মন্দিরে  :  মন্দির
মন্দিরও  :  মন্দিরও
মন্ত্রী  :  মন্ত্রী
মন্তিক  :  মন্তিক
মন্তব্য  :  মন্তব্য
মন্ডপ  :  মন্ডপ
মন্টেগু  :  মন্টেগু
মনোনীত  :  মনোনীত
মনুষ্য  :  মনুষ্য
মধ্যস্থতা  :  মধ্যস্থতা
মধ্যপ্রাচ্যের  :  মধ্যপ্রাচ্য
মধ্যপ্রস্তর  :  মধ্যপ্রস্ত
মধ্যদিয়ে  :  মধ্যদিয়
মদনপুরের  :  মদনপুর
মথুরা  :  মথুর
মঠে  :  মঠে
মঞ্জুর  :  মঞ্জু
মজুমদারের  :  মজুমদার
মজার  :  মজা
মখদুম  :  মখদুম
মকামাতে  :  মকামা
মকামাত  :  মকামাত
মকবুল  :  মকবুল
মকতবে  :  মকতব
মংডো  :  মংড
ভ্রমণের  :  ভ্রমণ
ভ্রমণকাহিনী  :  ভ্রমণকাহিনী
ভোজবর্মন  :  ভোজবর্মন
ভেসে  :  ভেস
ভেতরের  :  ভেতর
ভেতরই  :  ভেতরই
ভেঙ্গে  :  ভেঙ্গ
ভেঙে  :  ভেঙ
ভূমির  :  ভূমি
ভূমিমালিক  :  ভূমিমালিক
ভূখন্ডে  :  ভূখন্ড
ভূঁইয়া  :  ভূঁইয়া
ভীতসন্ত্রস্ত  :  ভীতসন্ত্রস্ত
ভিন্ন  :  ভিন্ন
ভিতর  :  ভিত
ভিড়  :  ভিড়
ভিটা  :  ভিটা
ভিক্ষুদের  :  ভিক্ষু
ভি  :  ভি
ভাস্কর্যটি  :  ভাস্কর্য
ভাসুবিহার  :  ভাসুবিহা
ভাষায়ও  :  ভাষায়ও
ভাষাপরিবারের  :  ভাষাপরিবার
ভারতকে  :  ভারতড
ভাবনা  :  ভাবনা
ভাব  :  ভাব
ভান্ডারের  :  ভান্ডার
ভান্ডারকারের  :  ভান্ডারকার
ভান্ডার  :  ভান্ডা
ভাত  :  ভাত
ভাঙ্গা  :  ভাঙ্গা
ভাঙ্গনখালির  :  ভাঙ্গনখালি
ভাইস  :  ভাইস
ভষ্মাধার  :  ভষ্মাধা
ভর্তি  :  ভর্তি
ভয়ে  :  ভয়
ভবদেব  :  ভবদেব
ভন্ডারকার  :  ভন্ডারকা
ভন  :  ভন
ভদ্রলোক  :  ভদ্রলোক
ভট্টাশালী  :  ভট্টাশালী
ভট্টশালীর  :  ভট্টশালী
ভঙ্গিতে  :  ভঙ্গি
ভগ্নাবস্থায়  :  ভগ্নাবস্থায়
ভক্তি  :  ভক্তি
ব্লাকিসটোন  :  ব্লাকিসটোন
ব্রাহ্ম  :  ব্রাহ্ম
ব্রাঞ্চ  :  ব্রাঞ্চ
ব্রহ্মগিরি  :  ব্রহ্মগিরি
ব্যারি  :  ব্যারি
ব্যাপী  :  ব্যাপী
ব্যাপকহারে  :  ব্যাপকহার
ব্যানার্জি  :  ব্যানার্জি
ব্যাখ্যার  :  ব্যাখ্যা
ব্যাকরণের  :  ব্যাকরণ
ব্যাংকটিকে  :  ব্যাংকটিড
ব্যাংকটি  :  ব্যাংক
ব্যস্ত  :  ব্যস্ত
ব্যর্থতায়  :  ব্যর্থতায়
ব্যর্থ  :  ব্যর্থ
ব্যয়ভার  :  ব্যয়ভা
ব্যবস্থাপনার  :  ব্যবস্থাপনা
ব্যবস্থাপনাধীন  :  ব্যবস্থাপনাধীন
ব্যবস্থাও  :  ব্যবস্থাও
ব্যবস্থাই  :  ব্যবস্থাই
ব্যবসায়ের  :  ব্যবসায়
ব্যবসায়ীকে  :  ব্যবসায়ীড
ব্যবসায়িক  :  ব্যবসায়িক
ব্যবসাকেন্দ্রে  :  ব্যবসাকেন্দ্র
ব্যবসা  :  ব্যবসা
ব্যতিক্রমধর্মী  :  ব্যতিক্রমধর্মী
ব্যঞ্জনবর্ণের  :  ব্যঞ্জনবর্ণ
ব্যক্তির  :  ব্যক্তি
ব্যক্তিগত  :  ব্যক্তিগত
ব্যক্ত  :  ব্যক্ত
বৌদ্ধযুগের  :  বৌদ্ধযুগ
বৌদ্ধধর্ম  :  বৌদ্ধধর্ম
বোসাউপিউ  :  বোসাউপিউ
বোধিসত্ত্ব  :  বোধিসত্ত্ব
বোধগয়া  :  বোধগয়া
বোধগম্য  :  বোধগম্য
বোদাউপায়ার  :  বোদাউপায়া
বোঝায়  :  বোঝায়
বৈশিষ্ট্যাবলি  :  বৈশিষ্ট্যাবলি
বৈশালী  :  বৈশালী
বৈরাগী  :  বৈরাগী
বৈপ্লবিক  :  বৈপ্লবিক
বৈদেশিক  :  বৈদেশিক
বৈচিত্র্যপূর্ণ  :  বৈচিত্র্যপূর্ণ
বেহারসহ  :  বেহারসহ
বেষ্টিত  :  বেষ্টিত
বেশির  :  বেশি
বেলুচিস্তানসহ  :  বেলুচিস্তানসহ
বেলুচিস্তান  :  বেলুচিস্তান
বেলাবো  :  বেলাব
বেরেলি  :  বেরেলি
বেরারসহ  :  বেরারসহ
বেভারিজ  :  বেভারিজ
বেদির  :  বেদি
বেদি  :  বেদি
বেচা  :  বেচা
বেগলারের  :  বেগলার
বৃহৎ  :  বৃহৎ
বৃদ্ধির  :  বৃদ্ধি
বৃত্তান্তের  :  বৃত্তান্ত
বৃক্ষবিদ্যার  :  বৃক্ষবিদ্যা
বৃক্ষছায়ায়  :  বৃক্ষছায়ায়
বৃক্ষ  :  বৃক্ষ
বুৎপত্তি  :  বুৎপত্তি
বুন্দেলখন্দে  :  বুন্দেলখন্দ
বুদ্ধিমত্তার  :  বুদ্ধিমত্তা
বুদ্ধিবৃত্তিক  :  বুদ্ধিবৃত্তিক
বুদ্ধমূর্তি  :  বুদ্ধমূর্তি
বুথিডং  :  বুথিডং
বুঘরা  :  বুঘর
বীরেন্দ্র  :  বীরেন্দ্
বীজগণিত  :  বীজগণিত
বিহারটির  :  বিহার
বিস্তৃতির  :  বিস্তৃতি
বিস্তারের  :  বিস্তার
বিস্তারিতভাবে  :  বিস্তারিতভাব
বিস্তার  :  বিস্তা
বিষয়েও  :  বিষয়েও
বিষয়টি  :  বিষয়
বিশ্লেষণের  :  বিশ্লেষণ
বিশ্লেষণ  :  বিশ্লেষণ
বিশ্ববিদ্যালয়গুলিতেও  :  বিশ্ববিদ্যালয়গুলিতেও
বিশ্ববিদ্যলয়ে  :  বিশ্ববিদ্যলয়
বিশেষত্ব  :  বিশেষত্ব
বিশেষজ্ঞের  :  বিশেষজ্ঞ
বিশেষজ্ঞগণ  :  বিশেষজ্ঞগণ
বিশালাকায়  :  বিশালাকায়
বিশাল  :  বিশাল
বিলুপ্তি  :  বিলুপ্তি
বিলসার  :  বিলসা
বিরোধে  :  বিরোধ
বিরাট  :  বিরাট
বিরতি  :  বিরতি
বিভ্রান্তির  :  বিভ্রান্তি
বিভ্রান্তি  :  বিভ্রান্তি
বিভাগটি  :  বিভাগ
বিবর্তনের  :  বিবর্তন
বিবরণীতে  :  বিবরণী
বিবরণমূলক  :  বিবরণমূলক
বিপ্লবের  :  বিপ্লব
বিন্যাসের  :  বিন্যাস
বিনিয়োগ  :  বিনিয়োগ
বিনিময়ের  :  বিনিময়
বিধৃত  :  বিধৃত
বিধিবদ্ধ  :  বিধিবদ্ধ
বিধানের  :  বিধান
বিদ্যোৎসাহী  :  বিদ্যোৎসাহী
বিদেশে  :  বিদেশ
বিদেশীদের  :  বিদেশী
বিতাড়িত  :  বিতাড়িত
বিজ্ঞানের  :  বিজ্ঞান
বিজ্ঞানভিত্তিক  :  বিজ্ঞানভিত্তিক
বিজাপুরে  :  বিজাপুর
বিজয়স্তম্ভের  :  বিজয়স্তম্ভ
বিজয়স্তম্ভ  :  বিজয়স্তম্ভ
বিজয়  :  বিজয়
বিচিত্র  :  বিচিত্
বিচারক  :  বিচারক
বিচার  :  বিচা
বিঘ্নিত  :  বিঘ্নিত
বিগত  :  বিগত
বিক্ষিপ্তভাবে  :  বিক্ষিপ্তভাব
বিক্রমশিলাকে  :  বিক্রমশিলাড
বিক্রমপুর  :  বিক্রমপু
বাহিরী  :  বাহিরী
বাহন  :  বাহন
বাসিস্হাটা  :  বাসিস্হাটা
বালিয়া  :  বালিয়া
বার্ষিকীতে  :  বার্ষিকী
বার্ষিক  :  বার্ষিক
বার্মিজ  :  বার্মিজ
বার্মার  :  বার্মা
বার্মায়  :  বার্মায়
বার্জেসের  :  বার্জেস
বার্জেসকে  :  বার্জেসড
বারী  :  বারী
বারবাক  :  বারবাক
বামনপুর  :  বামনপু
বাদ্য  :  বাদ্য
বাণিজ্যসম্ভার  :  বাণিজ্যসম্ভা
বাণিজ্য  :  বাণিজ্য
বাড়তে  :  বাড়
বাজেয়াপ্তকরণ  :  বাজেয়াপ্তকরণ
বাজেয়াপ্ত  :  বাজেয়াপ্ত
বাজানো  :  বাজান
বাছাই  :  বাছাই
বাঙালি  :  বাঙালি
বাক্যবিন্যাসে  :  বাক্যবিন্যাস
বাইশহাট  :  বাইশহাট
বাইশ  :  বাইশ
বাংলো  :  বাংল
বাঁকে  :  বাঁড
বহুমুখী  :  বহুমুখী
বহুকাল  :  বহুকাল
বহন  :  বহন
বস্ত্র  :  বস্ত্
বস্ত্তর  :  বস্ত্ত
বস্ত্তটির  :  বস্ত্ত
বস্ত্তগত  :  বস্ত্তগত
বসানো  :  বসান
বসতিসমূহে  :  বসতিসমূহ
বসতবাড়ি  :  বসতবাড়ি
বলেন  :  বলেন
বলবৎ  :  বলবৎ
বর্ধিত  :  বর্ধিত
বর্ধমান  :  বর্ধমান
বর্তমানকালের  :  বর্তমানকাল
বর্ণের  :  বর্ণ
বর্ণিত  :  বর্ণিত
বর্ণনাসমূহে  :  বর্ণনাসমূহ
বর্ণনায়  :  বর্ণনায়
বর্ণনাত্মক  :  বর্ণনাত্মক
বর্ণনাই  :  বর্ণনাই
বর্জন  :  বর্জন
বর্গাকৃত  :  বর্গাকৃত
বর্গফুট  :  বর্গফুট
বর্গ  :  বর্গ
বরেন্দ্রের  :  বরেন্দ্র
বরাবর  :  বরাব
বরবদুর  :  বরবদু
বয়স  :  বয়স
বন্য  :  বন্য
বন্দরের  :  বন্দর
বন্দরে  :  বন্দর
বন্দরসমূহের  :  বন্দরসমূহ
বন্দরগুলি  :  বন্দরগুলি
বন্দরকে  :  বন্দরড
বনে  :  বনে
বনবিদ্যার  :  বনবিদ্যা
বদ্ধ  :  বদ্ধ
বদাউন  :  বদাউন
বণিকরা  :  বণিকর
বণিকদের  :  বণিক
বণিকগণ  :  বণিকগণ
বণিক  :  বণিক
বটেশ্বরের  :  বটেশ্বর
বটেশ্বরে  :  বটেশ্বর
বজ্রসত্ত্বটি  :  বজ্রসত্ত্ব
বজ্রসত্ত্ব  :  বজ্রসত্ত্ব
বজরা  :  বজরা
বছরেরও  :  বছরেরও
বছরে  :  বছর
বচন  :  বচন
বঙ্গোপসাগর  :  বঙ্গোপসাগ
বঙ্গানুবাদ  :  বঙ্গানুবাদ
বঙ্গ  :  বঙ্গ
বকুলতলায়  :  বকুলতলায়
বইয়ের  :  বইয়
বই  :  বই
বংশবৃত্তান্তে  :  বংশবৃত্তান্
বংশধররা  :  বংশধরর
বংশ  :  বংশ
ব  :  ব
ফ্লিট  :  ফ্লিট
ফেলার  :  ফেলা
ফেলা  :  ফেলা
ফেলতেন  :  ফেলতেন
ফেব্রুয়ারি  :  ফেব্রুয়ারি
ফুল  :  ফুল
ফুরারের  :  ফুরার
ফুরার  :  ফুরা
ফুটেরও  :  ফুটেরও
ফুটিয়ে  :  ফুটিয়
ফী  :  ফী
ফিল  :  ফিল
ফিরিয়ে  :  ফিরিয়
ফিক্হশাস্ত্রে  :  ফিক্হশাস্ত্র
ফিক্হশাস্ত্র  :  ফিক্হশাস্ত্
ফার্সি  :  ফার্সি
ফার্ম  :  ফার্ম
ফারসিতে  :  ফারসি
ফান্ডের  :  ফান্ড
ফাঁপা  :  ফাঁপা
ফসলাদি  :  ফসলাদি
ফসল  :  ফসল
ফল্সফা  :  ফল্সফা
ফলাফলেরও  :  ফলাফলেরও
ফলাফলের  :  ফলাফল
ফলাদি  :  ফলাদি
ফলপ্রসূ  :  ফলপ্রসূ
ফলকের  :  ফলক
ফলকও  :  ফলকও
ফরজ  :  ফরজ
ফতেয়াবাদ  :  ফতেয়াবাদ
ফতেপুর  :  ফতেপু
প্রেসিডেন্ট  :  প্রেসিডেন্ট
প্রিন্সিপকে  :  প্রিন্সিপড
প্রাসাদ  :  প্রাসাদ
প্রার্থনার  :  প্রার্থনা
প্রায়োগিক  :  প্রায়োগিক
প্রামাণিক  :  প্রামাণিক
প্রাপ্তি  :  প্রাপ্তি
প্রান্তে  :  প্রান্
প্রান্তভাগে  :  প্রান্তভাগ
প্রাণীর  :  প্রাণী
প্রাচুর্যপূর্ণ  :  প্রাচুর্যপূর্ণ
প্রাচীনত্বের  :  প্রাচীনত্ব
প্রাচীনত্ব  :  প্রাচীনত্ব
প্রাচীনকালে  :  প্রাচীনকাল
প্রাচীনকাল  :  প্রাচীনকাল
প্রস্ত্তত  :  প্রস্ত্তত
প্রস্তাবের  :  প্রস্তাব
প্রস্তাবে  :  প্রস্তাব
প্রস্তাবকে  :  প্রস্তাবড
প্রসারিত  :  প্রসারিত
প্রসঙ্গে  :  প্রসঙ্গ
প্রসঙ্গত  :  প্রসঙ্গত
প্রসঙ্গ  :  প্রসঙ্গ
প্রশ্নে  :  প্রশ্ন
প্রশিক্ষিত  :  প্রশিক্ষিত
প্রশিক্ষণের  :  প্রশিক্ষণ
প্রশাসক  :  প্রশাসক
প্রশাখা  :  প্রশাখা
প্রশস্ত  :  প্রশস্ত
প্রশংসা  :  প্রশংসা
প্রয়োজনীয়তা  :  প্রয়োজনীয়তা
প্রমুখ  :  প্রমুখ
প্রমাণাদির  :  প্রমাণাদি
প্রমাণও  :  প্রমাণও
প্রভিন্স  :  প্রভিন্স
প্রভাষচন্দ্র  :  প্রভাষচন্দ্
প্রভাবের  :  প্রভাব
প্রভাবিত  :  প্রভাবিত
প্রবেশ্যতা  :  প্রবেশ্যতা
প্রবাদ  :  প্রবাদ
প্রবর্তিত  :  প্রবর্তিত
প্রবর্তনে  :  প্রবর্তন
প্রধানদের  :  প্রধান
প্রদেশসমূহ  :  প্রদেশসমূহ
প্রদীপ  :  প্রদীপ
প্রদানের  :  প্রদান
প্রদানে  :  প্রদান
প্রদর্শিত  :  প্রদর্শিত
প্রদর্শনের  :  প্রদর্শন
প্রদর্শন  :  প্রদর্শন
প্রথমবারের  :  প্রথমবার
প্রথমটির  :  প্রথম
প্রত্যেকটির  :  প্রত্যেক
প্রত্যেকটি  :  প্রত্যেক
প্রত্নস্থলটিতে  :  প্রত্নস্থল
প্রত্নস্থলগুলিও  :  প্রত্নস্থলগুলিও
প্রত্নস্থলগুলি  :  প্রত্নস্থলগুলি
প্রত্নবস্ত্তসমূহ  :  প্রত্নবস্ত্তসমূহ
প্রত্নবস্ত্তটি  :  প্রত্নবস্ত্ত
প্রত্নতত্ত্ববিদের  :  প্রত্নতত্ত্ববি
প্রত্নতত্ত্ববিদগণ  :  প্রত্নতত্ত্ববিদগণ
প্রত্নতত্ত্ববিদ  :  প্রত্নতত্ত্ববিদ
প্রত্নতত্ত্বকে  :  প্রত্নতত্ত্বড
প্রত্নচর্চার  :  প্রত্নচর্চা
প্রত্নক্ষেত্রকে  :  প্রত্নক্ষেত্রড
প্রত্নকীর্তিটির  :  প্রত্নকীর্তি
প্রত্নকীর্তি  :  প্রত্নকীর্তি
প্রত্নএলাকা  :  প্রত্নএলাকা
প্রত্নঅঞ্চলটির  :  প্রত্নঅঞ্চল
প্রত্নঅঞ্চলটি  :  প্রত্নঅঞ্চল
প্রতীয়মান  :  প্রতীয়মান
প্রতিষ্ঠালগ্ন  :  প্রতিষ্ঠালগ্ন
প্রতিষ্ঠানে  :  প্রতিষ্ঠান
প্রতিষঙ্গী  :  প্রতিষঙ্গী
প্রতিশ্রুতি  :  প্রতিশ্রুতি
প্রতিরক্ষা  :  প্রতিরক্ষা
প্রতিমূর্তির  :  প্রতিমূর্তি
প্রতিমা  :  প্রতিমা
প্রতিভা  :  প্রতিভা
প্রতিবেশী  :  প্রতিবেশী
প্রতিবেদনের  :  প্রতিবেদন
প্রতিবেদনে  :  প্রতিবেদন
প্রতিবেদনও  :  প্রতিবেদনও
প্রতিবছর  :  প্রতিবছ
প্রতিদিনের  :  প্রতিদিন
প্রণয়নের  :  প্রণয়ন
প্রডাক্ট  :  প্রডাক্ট
প্রচারে  :  প্রচার
প্রচারকগণ  :  প্রচারকগণ
প্রক্রিয়া  :  প্রক্রিয়া
প্রকৌশলীর  :  প্রকৌশলী
প্রকৌশল  :  প্রকৌশল
প্রকৃতপক্ষে  :  প্রকৃতপক্ষ
প্রকাশনার  :  প্রকাশনা
প্যাগান  :  প্যাগান
পৌরাণিক  :  পৌরাণিক
পৌরবিজ্ঞান  :  পৌরবিজ্ঞান
পৌঁছেছিল  :  পৌঁছেছিল
পৌঁছাত  :  পৌঁছাত
পোড়ামাটি  :  পোড়ামা
পোড়া  :  পোড়া
পেত  :  পেত
পেছনের  :  পেছন
পেছনে  :  পেছন
পেঁপে  :  পেঁপ
পৃষ্ঠপোষকতা  :  পৃষ্ঠপোষকতা
পৃষ্ঠ  :  পৃষ্ঠ
পৃথক  :  পৃথক
পূর্বেই  :  পূর্বেই
পূর্বাংশের  :  পূর্বাংশ
পূর্বাংশে  :  পূর্বাংশ
পূর্বপুরুষরা  :  পূর্বপুরুষর
পূর্বপুরুষদের  :  পূর্বপুরুষ
পূর্বপুরুষ  :  পূর্বপুরুষ
পূর্বপাশের  :  পূর্বপাশ
পূর্ত  :  পূর্ত
পূর্ণাঙ্গ  :  পূর্ণাঙ্গ
পূজক  :  পূজক
পূ  :  পূ
পুষ্পাধার  :  পুষ্পাধা
পুষ্প  :  পুষ্প
পুষিয়ে  :  পুষিয়
পুরুষের  :  পুরুষ
পুরুষাকৃতির  :  পুরুষাকৃতি
পুরু  :  পুরু
পুরাবস্ত্ত  :  পুরাবস্ত্ত
পুরাকীর্তির  :  পুরাকীর্তি
পুরস্কৃত  :  পুরস্কৃত
পুন্ড্রবর্ধন  :  পুন্ড্রবর্ধন
পুন্ড্রনগরসহ  :  পুন্ড্রনগরসহ
পুনর্দখল  :  পুনর্দখল
পুনর্জীবিত  :  পুনর্জীবিত
পুনর্গঠন  :  পুনর্গঠন
পুনরুজ্জীবিত  :  পুনরুজ্জীবিত
পুনরুজ্জীবনে  :  পুনরুজ্জীবন
পুনঃসংগঠিত  :  পুনঃসংগঠিত
পুনঃপ্রবর্তন  :  পুনঃপ্রবর্তন
পুনঃপ্রতিষ্ঠার  :  পুনঃপ্রতিষ্ঠা
পুনঃনির্ধারিত  :  পুনঃনির্ধারিত
পুন  :  পুন
পুত্র  :  পুত্
পুকুরতলা  :  পুকুরতলা
পুকুর  :  পুকু
পুঁতি  :  পুঁতি
পি  :  পি
পাহাড়  :  পাহাড়
পাস  :  পাস
পাশে  :  পাশ
পাশা  :  পাশা
পাশ  :  পাশ
পাল্টে  :  পাল্ট
পার্শ্বনাথ  :  পার্শ্বনাথ
পার্কও  :  পার্কও
পারিবারিক  :  পারিবারিক
পারদর্শিতা  :  পারদর্শিতা
পায়  :  পায়
পাবলিকেশন্সের  :  পাবলিকেশন্স
পাবনার  :  পাবনা
পান্ডুলিপি  :  পান্ডুলিপি
পান্ডিত্যের  :  পান্ডিত্য
পানীয়জলের  :  পানীয়জল
পান  :  পান
পাত্রগুলি  :  পাত্রগুলি
পাত্রও  :  পাত্রও
পাতার  :  পাতা
পাতলা  :  পাতলা
পাতকুয়া  :  পাতকুয়া
পাত  :  পাত
পাড়ের  :  পাড়
পাঠ্যসূচির  :  পাঠ্যসূচি
পাঠ্যসূচিতে  :  পাঠ্যসূচি
পাঠে  :  পাঠ
পাঠানরা  :  পাঠানর
পাঠন  :  পাঠন
পাঠদান  :  পাঠদান
পাটালিপুত্র  :  পাটালিপুত্
পাট  :  পাট
পাচরুখি  :  পাচরুখি
পাগড়ি  :  পাগড়ি
পাখা  :  পাখা
পাকিস্তানের  :  পাকিস্তান
পাকবাহিনী  :  পাকবাহিনী
পাক  :  পাক
পশ্চিমাঞ্চল  :  পশ্চিমাঞ্চল
পশ্চাৎপদ  :  পশ্চাৎপদ
পল্লী  :  পল্লী
পল্লিবিদ্যুতায়ন  :  পল্লিবিদ্যুতায়ন
পর্ষদ  :  পর্ষদ
পর্যস্ত  :  পর্যস্ত
পর্যবেক্ষণসমূহ  :  পর্যবেক্ষণসমূহ
পর্যবেক্ষণ  :  পর্যবেক্ষণ
পর্যবসিত  :  পর্যবসিত
পর্যটকগণ  :  পর্যটকগণ
পর্বতশৃঙ্গ  :  পর্বতশৃঙ্গ
পরীক্ষায়  :  পরীক্ষায়
পরীক্ষণ  :  পরীক্ষণ
পরিহিত  :  পরিহিত
পরিস্ফুটিত  :  পরিস্ফুটিত
পরিস্থিতি  :  পরিস্থিতি
পরিসমাপ্তি  :  পরিসমাপ্তি
পরিষৎটিতে  :  পরিষৎ
পরিষৎ  :  পরিষৎ
পরিষদের  :  পরিষ
পরিশ্রমী  :  পরিশ্রমী
পরিলক্ষিত  :  পরিলক্ষিত
পরিমাপন  :  পরিমাপন
পরিভাষায়  :  পরিভাষায়
পরিব্রাজক  :  পরিব্রাজক
পরিবর্ধন  :  পরিবর্ধন
পরিপূরণের  :  পরিপূরণ
পরিপার্শ্ব  :  পরিপার্শ্ব
পরিধি  :  পরিধি
পরিদর্শনের  :  পরিদর্শন
পরিচ্ছদ  :  পরিচ্ছদ
পরিচয়বাহী  :  পরিচয়বাহী
পরিকল্পিত  :  পরিকল্পিত
পরিকল্পনাকে  :  পরিকল্পনাড
পরস্পরের  :  পরস্পর
পরপরই  :  পরপরই
পরগণার  :  পরগণা
পরও  :  পরও
পরই  :  পরই
পন্ডিতব্যক্তি  :  পন্ডিতব্যক্তি
পন্ডিতদের  :  পন্ডিত
পন্ডিত  :  পন্ডিত
পন্ডিচেরির  :  পন্ডিচেরি
পদ্যে  :  পদ্য
পদ্মাবতী  :  পদ্মাবতী
পদ্ধতিরও  :  পদ্ধতিরও
পদ্ধতিতে  :  পদ্ধতি
পদত্যাগ  :  পদত্যাগ
পদগুলো  :  পদগুল
পথে  :  পথে
পথপ্রদর্শকের  :  পথপ্রদর্শক
পত্রিকায়  :  পত্রিকায়
পড়েছিল  :  পড়েছিল
পড়ানো  :  পড়ান
পট্টিকেরা  :  পট্টিক
পটিয়ার  :  পটিয়া
পটভূমিতে  :  পটভূমি
পঞ্চাশ  :  পঞ্চাশ
পঞ্চপ্রদীপ  :  পঞ্চপ্রদীপ
পঞ্চ  :  পঞ্চ
পক্ষেও  :  পক্ষেও
পক্ষান্তরে  :  পক্ষান্তর
পক্ষকে  :  পক্ষড
নোয়াখালীর  :  নোয়াখালী
নোয়াখালীতে  :  নোয়াখালী
নোটিশের  :  নোটিশ
নোটিশ  :  নোটিশ
নৈকট্যের  :  নৈকট্য
নেমিনাথ  :  নেমিনাথ
নেপালসহ  :  নেপালসহ
নেতৃবৃন্দের  :  নেতৃবৃন্
নেতৃত্ব  :  নেতৃত্ব
নেওয়া  :  নেওয়া
নূতন  :  নূতন
নুড়িময়  :  নুড়িময়
নীতিসমূহ  :  নীতিসমূহ
নীতিমালা  :  নীতিমালা
নীতিবিদ্যা  :  নীতিবিদ্যা
নিহত  :  নিহত
নিষ্পত্তি  :  নিষ্পত্তি
নিষ্কাশন  :  নিষ্কাশন
নিশ্চিন্ত  :  নিশ্চিন্ত
নিশ্চিতকরণের  :  নিশ্চিতকরণ
নিশ্চিতকরণ  :  নিশ্চিতকরণ
নিশাপুরী  :  নিশাপুরী
নিলোর  :  নিল
নির্মাতা  :  নির্মাতা
নির্ভরশীল  :  নির্ভরশীল
নির্বাহী  :  নির্বাহী
নির্ধারিত  :  নির্ধারিত
নির্ধারণের  :  নির্ধারণ
নির্দেশের  :  নির্দেশ
নির্দেশে  :  নির্দেশ
নির্দেশনার  :  নির্দেশনা
নির্দশন  :  নির্দশন
নির্ণয়  :  নির্ণয়
নিরূপণের  :  নিরূপণ
নিরূপণ  :  নিরূপণ
নিরীক্ষা  :  নিরীক্ষা
নিযুক্তির  :  নিযুক্তি
নিযুক্তি  :  নিযুক্তি
নিযামউদ্দীন  :  নিযামউদ্দীন
নিয়োজিত  :  নিয়োজিত
নিয়োগকৃত  :  নিয়োগকৃত
নিয়মিতভাবে  :  নিয়মিতভাব
নিয়মাবলী  :  নিয়মাবলী
নিয়ন্ত্রিত  :  নিয়ন্ত্রিত
নিয়ন্ত্রণে  :  নিয়ন্ত্রণ
নিম্নভাবে  :  নিম্নভাব
নিম্ন  :  নিম্ন
নিবেদিত  :  নিবেদিত
নিবন্ধন  :  নিবন্ধন
নিন্দা  :  নিন্দা
নিদর্শসসমূহ  :  নিদর্শসসমূহ
নিদর্শনগুলিও  :  নিদর্শনগুলিও
নিদর্শনগুলি  :  নিদর্শনগুলি
নিদর্শনই  :  নিদর্শনই
নাহ্ওমীর  :  নাহ্ওমী
নাহ্ও  :  নাহ্ও
নাসিরুদ্দীন  :  নাসিরুদ্দীন
নালগোরা  :  নালগোর
নার্সারি  :  নার্সারি
নারীর  :  নারী
নারায়ণগঞ্জ  :  নারায়ণগঞ্জ
নামানুসারে  :  নামানুসার
নামটি  :  নাম
নামকরণও  :  নামকরণও
নাফ  :  নাফ
নাগরিকের  :  নাগরিক
নাগরিকত্ব  :  নাগরিকত্ব
নাগরিক  :  নাগরিক
নাগপুরসহ  :  নাগপুরসহ
নস্র  :  নস্
নষ্ট  :  নষ্ট
নলিনীকান্ত  :  নলিনীকান্ত
নলকূপ  :  নলকূপ
নর্মদা  :  নর্মদা
নর্তকী  :  নর্তকী
নরসিংদীতে  :  নরসিংদী
নরমিখলা  :  নরমিখলা
নয়ল  :  নয়ল
নয়টি  :  নয়
নব্যপ্রস্তর  :  নব্যপ্রস্ত
নব্য  :  নব্য
নতুনত্ব  :  নতুনত্ব
নগরের  :  নগর
নগরসমূহের  :  নগরসমূহ
নগরকেন্দ্র  :  নগরকেন্দ্
নকশাকার  :  নকশাকা
নকল  :  নকল
নওয়াবগঞ্জ  :  নওয়াবগঞ্জ
নওগাঁর  :  নওগাঁ
ধ্রুপদী  :  ধ্রুপদী
ধ্বনিবিজ্ঞান  :  ধ্বনিবিজ্ঞান
ধ্বংসাবশেষকে  :  ধ্বংসাবশেষড
ধ্বংসস্তুপ  :  ধ্বংসস্তুপ
ধ্বংসসাধনের  :  ধ্বংসসাধন
ধূসর  :  ধূস
ধূপধুনা  :  ধূপধুনা
ধীবর  :  ধীব
ধারাকেও  :  ধারাকেও
ধারণায়  :  ধারণায়
ধারণাই  :  ধারণাই
ধারণ  :  ধারণ
ধাতব  :  ধাতব
ধর্মাবলম্বীদের  :  ধর্মাবলম্বী
ধর্মপ্রচারে  :  ধর্মপ্রচার
ধর্মপালদেব  :  ধর্মপালদেব
ধর্মপাল  :  ধর্মপাল
ধরপাকড়  :  ধরপাকড়
ধবংসের  :  ধবংস
ধতংসাবশেষের  :  ধতংসাবশেষ
দ্রাবিড়  :  দ্রাবিড়
দ্রাঘিমাংশ  :  দ্রাঘিমাংশ
দ্রব্যাদি  :  দ্রব্যাদি
দ্রব্য  :  দ্রব্য
দ্বৈত  :  দ্বৈত
দ্বীপে  :  দ্বীপ
দ্বীপ  :  দ্বীপ
দ্বিতীয়টির  :  দ্বিতীয়
দ্বিতল  :  দ্বিতল
দৌলা  :  দৌলা
দৈনিক  :  দৈনিক
দৈনন্দিন  :  দৈনন্দিন
দৈত্য  :  দৈত্য
দেহের  :  দেহ
দেহাবশেষের  :  দেহাবশেষ
দেশিয়  :  দেশিয়
দেশি  :  দেশি
দেশসমূহ  :  দেশসমূহ
দেশকে  :  দেশড
দেশ  :  দেশ
দেয়াল  :  দেয়াল
দেয়ার  :  দেয়া
দেবেন  :  দেবেন
দেবমূর্তির  :  দেবমূর্তি
দেবপূজার  :  দেবপূজা
দেবতা  :  দেবতা
দেবখড়গের  :  দেবখড়গ
দেখাশুনার  :  দেখাশুনা
দেখায়নি  :  দেখায়
দৃষ্টিভঙ্গির  :  দৃষ্টিভঙ্গি
দৃষ্টি  :  দৃষ্
দৃষ্টান্তস্বরূপ  :  দৃষ্টান্তস্বরূপ
দৃশ্যমান  :  দৃশ্যমান
দৃশ্যচিত্রের  :  দৃশ্যচিত্র
দৃঢ়  :  দৃঢ়
দূরত্ব  :  দূরত্ব
দুষ্প্রাপ্য  :  দুষ্প্রাপ্য
দুলকি  :  দুলকি
দুর্বলতার  :  দুর্বলতা
দুর্গা  :  দুর্গা
দুর্গসমূহ  :  দুর্গসমূহ
দুর্গরক্ষক  :  দুর্গরক্ষক
দুর্গও  :  দুর্গও
দুযুগ  :  দুযুগ
দুভাগে  :  দুভাগ
দুপর্যায়ে  :  দুপর্যায়
দুটির  :  দুটি
দুজন  :  দুজন
দুওয়াম  :  দুওয়াম
দুইভাগে  :  দুইভাগ
দুঃসাধ্য  :  দুঃসাধ্য
দীর্ঘমেয়াদি  :  দীর্ঘমেয়াদি
দীর্ঘদিন  :  দীর্ঘদিন
দীপমালা  :  দীপমালা
দীন  :  দীন
দীউয়ানি  :  দীউয়া
দিল্লী  :  দিল্লী
দিল্লির  :  দিল্লি
দিলিপ  :  দিলিপ
দিয়েছে  :  দিয়েছ
দিয়াফত  :  দিয়াফত
দিবে  :  দিব
দিনে  :  দিন
দিনাজপুর  :  দিনাজপু
দিন  :  দিন
দিতে  :  দিত
দিঘির  :  দিঘি
দিঘি  :  দিঘি
দিঘাপতিয়ার  :  দিঘাপতিয়া
দিগম্বর  :  দিগম্ব
দিগন্ত  :  দিগন্ত
দিকের  :  দিক
দিওয়ান  :  দিওয়ান
দি  :  দি
দালিলিক  :  দালিলিক
দালানকোঠার  :  দালানকোঠা
দারোগাসহ  :  দারোগাসহ
দায়িত্বে  :  দায়িত্ব
দায়িত্বও  :  দায়িত্বও
দায়ভাগ  :  দায়ভাগ
দামের  :  দাম
দামী  :  দামী
দানাদার  :  দানাদা
দানবাকৃতির  :  দানবাকৃতি
দানব  :  দানব
দাঁতের  :  দাঁত
দলিল  :  দলিল
দলবদ্ধ  :  দলবদ্ধ
দলনেতা  :  দলনেতা
দল  :  দল
দরবারে  :  দরবার
দরগাঁও  :  দরগাঁও
দয়ারাম  :  দয়ারাম
দন্ডের  :  দন্ড
দন্ডে  :  দন্ড
দন্ডিত  :  দন্ডিত
দন্ডায়মান  :  দন্ডায়মান
দন্ডই  :  দন্ডই
দখলের  :  দখল
দখলে  :  দখল
দখল  :  দখল
দক্ষিণের  :  দক্ষিণ
দক্ষিণপূর্ব  :  দক্ষিণপূর্ব
দক্ষতাসহ  :  দক্ষতাসহ
দক্ষতায়  :  দক্ষতায়
দক্ষতা  :  দক্ষতা
দক্ষ  :  দক্ষ
দ  :  দ
থু  :  থু
থান  :  থান
থাদোমেন্তরের  :  থাদোমেন্তর
থাকার  :  থাকা
থাকা  :  থাকা
থাকলে  :  থাকল
থাকতেন  :  থাকতেন
তৎকালে  :  তৎকাল
ত্রিরথ  :  ত্রিরথ
ত্রয়  :  ত্রয়
তোলেন  :  তোলেন
তোলে  :  তোল
তোলা  :  তোলা
তৈরিতে  :  তৈরি
তেলাওয়াত  :  তেলাওয়াত
তেমনিভাবে  :  তেমনিভাব
তেমনি  :  তেম
তুহফাতুল্  :  তুহফাতুল্
তুলনায়  :  তুলনায়
তীরের  :  তীর
তিনিই  :  তিনিই
তাৎপর্যের  :  তাৎপর্য
তাৎপর্য  :  তাৎপর্য
তাসত্ত্বেও  :  তাসত্ত্বেও
তারিখে  :  তারিখ
তারও  :  তারও
তায়িং  :  তায়িং
তাম্রশাসনের  :  তাম্রশাসন
তাম্রশাসনটি  :  তাম্রশাসন
তাম্রলিপ্তিই  :  তাম্রলিপ্তিই
তাম্র  :  তাম্
তামার  :  তামা
তামা  :  তামা
তামবুকিয়া  :  তামবুকিয়া
তাফসীরুফত্হিল  :  তাফসীরুফত্হিল
তাফসিরও  :  তাফসিরও
তাদেরকে  :  তাদেরড
তাত্ত্বিক  :  তাত্ত্বিক
তাজমহল  :  তাজমহল
তাছাড়া  :  তাছাড়া
তাকে  :  তাক
তাওহিদ  :  তাওহিদ
তাঁদের  :  তাঁ
তাঁতশিল্প  :  তাঁতশিল্প
তস্করবৃত্তির  :  তস্করবৃত্তি
তলোয়ার  :  তলোয়া
তলানিই  :  তলানিই
তমলুকে  :  তমলুড
তথ্যসূত্র  :  তথ্যসূত্
তত্ত্বাবধানে  :  তত্ত্বাবধান
তক্ষশীলা  :  তক্ষশীলা
তকীউদ্দীন  :  তকীউদ্দীন
তওয়ামা  :  তওয়ামা
তইং  :  তইং
ঢোল  :  ঢোল
ঢিবিসমূহ  :  ঢিবিসমূহ
ঢিবির  :  ঢিবি
ঢিবিতে  :  ঢিবি
ঢিবিকে  :  ঢিবিড
ঢাকায়  :  ঢাকায়
ঢাক  :  ঢাক
ডোমিনিয়নের  :  ডোমিনিয়ন
ডেবিট  :  ডেবিট
ডিভোলিউশন  :  ডিভোলিউশন
ডিক্রি  :  ডিক্রি
ডিউক  :  ডিউক
ডানা  :  ডানা
ডাকের  :  ডাক
ডাকাতদের  :  ডাকাত
ডাইসন  :  ডাইসন
ঠিকাদারদের  :  ঠিকাদার
ট্রিটমেন্টের  :  ট্রিটমেন্ট
ট্যাপ  :  ট্যাপ
টেকনিক্যাল  :  টেকনিক্যাল
টিরও  :  টিরও
টানিয়ে  :  টানিয়
টাকায়  :  টাকায়
টাউনে  :  টাউন
টন  :  টন
ঝুঁকিপূর্ণ  :  ঝুঁকিপূর্ণ
জ্যোতিষতত্ত্ব  :  জ্যোতিষতত্ত্ব
জ্যোতির্বিজ্ঞান  :  জ্যোতির্বিজ্ঞান
জ্যাসপার  :  জ্যাসপা
জ্যামিতি  :  জ্যামিতি
জ্ঞাপন  :  জ্ঞাপন
জ্ঞানের  :  জ্ঞান
জ্ঞানার্জন  :  জ্ঞানার্জন
জ্ঞানসম্পন্ন  :  জ্ঞানসম্পন্ন
জৌনপুরের  :  জৌনপুর
জোর  :  জোর
জোনস  :  জোনস
জৈন্তিয়ার  :  জৈন্তিয়া
জৈনতীর্থঙ্কর  :  জৈনতীর্থঙ্ক
জেলায়  :  জেলায়
জুলাই  :  জুলাই
জীবিত  :  জীবিত
জীবনে  :  জীবন
জীবনধারার  :  জীবনধারা
জীবনচিত্র  :  জীবনচিত্
জীবন  :  জীবন
জিব্রালটার  :  জিব্রালটা
জিনিসপত্রগুলি  :  জিনিসপত্রগুলি
জিনিসও  :  জিনিসও
জিন  :  জিন
জিকরা  :  জিকর
জাহাজগুলিকে  :  জাহাজগুলিড
জাহাজ  :  জাহাজ
জাল  :  জাল
জার্নাল  :  জার্নাল
জারী  :  জারী
জারি  :  জারি
জায়েদ  :  জায়েদ
জায়সীর  :  জায়সী
জায়গা  :  জায়গা
জামে  :  জাম
জামিয়া  :  জামিয়া
জাম  :  জাম
জাফরির  :  জাফরি
জাফরাবাদ  :  জাফরাবাদ
জাপানের  :  জাপান
জানিয়েছিলেন  :  জানিয়েছিলেন
জানানোর  :  জানান
জাদুঘরের  :  জাদুঘর
জাদুঘরে  :  জাদুঘর
জাদুঘরটি  :  জাদুঘর
জাতিতাত্ত্বিক  :  জাতিতাত্ত্বিক
জাঙ্গলিয়া  :  জাঙ্গলিয়া
জাঁহাপুর  :  জাঁহাপু
জলাশয়  :  জলাশয়
জলবায়ু  :  জলবায়ু
জলপূর্ণ  :  জলপূর্ণ
জলধারণ  :  জলধারণ
জলতাত্ত্বিকভাবে  :  জলতাত্ত্বিকভাব
জল  :  জল
জরুরি  :  জরুরি
জরিপসমূহের  :  জরিপসমূহ
জরিপসমূহ  :  জরিপসমূহ
জরিপকার  :  জরিপকা
জয়  :  জয়
জমিদারের  :  জমিদার
জমায়  :  জমায়
জমতে  :  জমত
জন্যও  :  জন্যও
জন্যই  :  জন্যই
জন্তুর  :  জন্তু
জনে  :  জনে
জনাব  :  জনাব
জনসংখ্যার  :  জনসংখ্যা
জনশক্তি  :  জনশক্তি
জনবসতি  :  জনবসতি
জনপ্রিয়  :  জনপ্রিয়
জনপথ  :  জনপথ
জটিল  :  জটিল
জঙ্গলের  :  জঙ্গল
জঙ্গলী  :  জঙ্গলী
জঙ্গল  :  জঙ্গল
জগদ্দলের  :  জগদ্দল
জগদ্দল  :  জগদ্দল
ছোটখাট  :  ছোটখাট
ছেড়ে  :  ছেড়
ছিদ্র  :  ছিদ্
ছিটিয়ে  :  ছিটিয়
ছাপানোর  :  ছাপান
ছাদের  :  ছাদ
ছাদ  :  ছাদ
ছাত্রীরা  :  ছাত্রীর
ছাত্রদের  :  ছাত্র
ছাগলনাইয়াতে  :  ছাগলনাইয়া
ছাঁচ  :  ছাঁচ
ছয়  :  ছয়
ছড়িয়ে  :  ছড়িয়
ছক  :  ছক
চৌধুরীর  :  চৌধুরী
চৌধুরী  :  চৌধুরী
চৌদ্দ  :  চৌদ্দ
চোখে  :  চোখ
চৈত্য  :  চৈত্য
চৈতন্যের  :  চৈতন্য
চেয়েও  :  চেয়েও
চেয়ারম্যানের  :  চেয়ারম্যান
চেম্সফোর্ড  :  চেম্সফোর্ড
চূড়ান্ত  :  চূড়ান্ত
চুরি  :  চুরি
চুয়ায়  :  চুয়ায়
চুনাপাথর  :  চুনাপাথ
চুড়িহাট্টা  :  চুড়িহাট্টা
চুক্তিভঙ্গের  :  চুক্তিভঙ্গ
চীনামাটি  :  চীনামা
চিহ্নিত  :  চিহ্নিত
চিহ্ন  :  চিহ্ন
চিনা  :  চিনা
চিত্রায়িত  :  চিত্রায়িত
চিত্রসহ  :  চিত্রসহ
চিত্তাকর্ষক  :  চিত্তাকর্ষক
চিটাগাং  :  চিটাগাং
চিকিৎসাবিজ্ঞান  :  চিকিৎসাবিজ্ঞান
চাহিদা  :  চাহিদা
চাষ  :  চাষ
চালানো  :  চালান
চালান  :  চালান
চালাতে  :  চালা
চালা  :  চালা
চারা  :  চারা
চারশ  :  চারশ
চার  :  চার
চামুন্ডা  :  চামুন্ডা
চানহুডারোতে  :  চানহুডার
চাছুঁনি  :  চাছুঁ
চাকলাপুঞ্জিতে  :  চাকলাপুঞ্জি
চাকরি  :  চাকরি
চল্লিশের  :  চল্লিশ
চলতে  :  চলত
চলছে  :  চলছ
চরিত্র  :  চরিত্
চম্পাদেউলিয়া  :  চম্পাদেউলিয়া
চন্দ্রের  :  চন্দ্র
চন্দ্রকেতুগড়ে  :  চন্দ্রকেতুগড়
চন্দন  :  চন্দন
চন্দ  :  চন্দ
চত্বরযুক্ত  :  চত্বরযুক্ত
চতুর্ভুজাকৃতির  :  চতুর্ভুজাকৃতি
চতুর্ভুজাকৃতি  :  চতুর্ভুজাকৃতি
চতুর্ভুজাকার  :  চতুর্ভুজাকা
চক্রবর্তীর  :  চক্রবর্তী
চক্রবর্তী  :  চক্রবর্তী
ঙ  :  ঙ
ঘোষিত  :  ঘোষিত
ঘোষণার  :  ঘোষণা
ঘোরানো  :  ঘোরান
ঘোপার  :  ঘোপা
ঘিরে  :  ঘির
ঘাস  :  ঘাস
ঘাটি  :  ঘাটি
ঘাটনগর  :  ঘাটনগ
ঘাটতি  :  ঘাটতি
ঘাঁটি  :  ঘাঁ
ঘনিষ্ট  :  ঘনিষ্ট
ঘণ্টাটির  :  ঘণ্টা
ঘণ্টা  :  ঘণ্টা
ঘটেছে  :  ঘটেছ
ঘটানো  :  ঘটান
ঘটনাবলি  :  ঘটনাবলি
ঘ  :  ঘ
গ্রুপ  :  গ্রুপ
গ্রাহক  :  গ্রাহক
গ্রামে  :  গ্রাম
গ্রামাঞ্চলে  :  গ্রামাঞ্চল
গ্রামসমূহে  :  গ্রামসমূহ
গ্রহণের  :  গ্রহণ
গ্রন্থাগারে  :  গ্রন্থাগার
গ্রন্থাগারটি  :  গ্রন্থাগার
গ্রন্থপঞ্জি  :  গ্রন্থপঞ্জি
গ্রন্থটি  :  গ্রন্থ
গ্রন্থগুলিও  :  গ্রন্থগুলিও
গৌণ  :  গৌণ
গৌড়  :  গৌড়
গোসল  :  গোসল
গোলাকার  :  গোলাকা
গোলাকান্দাইলের  :  গোলাকান্দাইল
গোবিন্দ  :  গোবিন্দ
গোপালদি  :  গোপালদি
গোপলাপুর  :  গোপলাপু
গোপন  :  গোপন
গোদাবরীতে  :  গোদাবরী
গোড়ার  :  গোড়া
গোকুল  :  গোকুল
গেলেও  :  গেলেও
গেছেন  :  গেছেন
গেঁথে  :  গেঁথ
গৃহস্থালীর  :  গৃহস্থালী
গুসল  :  গুসল
গুল্ম  :  গুল্ম
গুলোকে  :  গুলোড
গুরুত্বের  :  গুরুত্ব
গুরুত্ববহ  :  গুরুত্ববহ
গুপ্তযুগেও  :  গুপ্তযুগেও
গুটিকাগুলিতে  :  গুটিকাগুলি
গুটিকাগুলি  :  গুটিকাগুলি
গুজরাট  :  গুজরাট
গিরিশচন্দ্র  :  গিরিশচন্দ্
গিয়ে  :  গিয়
গার্নেট  :  গার্নেট
গায়ে  :  গায়
গায়িকা  :  গায়িকা
গামলার  :  গামলা
গামছা  :  গামছা
গাড়িও  :  গাড়িও
গাড়ি  :  গাড়ি
গাঙ্গেয়  :  গাঙ্গেয়
গর্ভগৃহ  :  গর্ভগৃহ
গর্ত  :  গর্ত
গরীবুল্লাহ  :  গরীবুল্লাহ
গরিষ্ঠতা  :  গরিষ্ঠতা
গরবা  :  গরবা
গয়া  :  গয়া
গম্বুজ  :  গম্বুজ
গম  :  গম
গভীরভাবে  :  গভীরভাব
গভীরতা  :  গভীরতা
গভীরতর  :  গভীরত
গবেষণাসমূহ  :  গবেষণাসমূহ
গদ্যে  :  গদ্য
গতির  :  গতি
গড়  :  গড়
গজল  :  গজল
গঙ্গ  :  গঙ্গ
খ্রিস্টাব্দ  :  খ্রিস্টাব্দ
খ্রিস্টান  :  খ্রিস্টান
খ্রিস্টপূর্বাব্দে  :  খ্রিস্টপূর্বাব্দ
খ্রিস্টপূর্বাব্দ  :  খ্রিস্টপূর্বাব্দ
খ্রিস্টপূর্ব  :  খ্রিস্টপূর্ব
খ্রিস্ট  :  খ্রিস্ট
খোদিত  :  খোদিত
খালিজ  :  খালিজ
খানের  :  খান
খানী  :  খানী
খাদ্য  :  খাদ্য
খাতে  :  খাত
খাজের  :  খাজ
খাকী  :  খাকী
খাঁটি  :  খাঁ
খন্ডও  :  খন্ডও
খনা  :  খনা
খননকৃত  :  খননকৃত
খননকার্যের  :  খননকার্য
খড়গদের  :  খড়গ
ক্ষেত্র  :  ক্ষেত্
ক্ষুদ্রাকৃতি  :  ক্ষুদ্রাকৃতি
ক্ষুদ্রাকৃত  :  ক্ষুদ্রাকৃত
ক্ষীণ  :  ক্ষীণ
ক্ষয়প্রাপ্ত  :  ক্ষয়প্রাপ্ত
ক্ষমতাসম্পন্ন  :  ক্ষমতাসম্পন্ন
ক্ষমতায়  :  ক্ষমতায়
ক্ষতিসাধন  :  ক্ষতিসাধন
ক্লিবলিঙ্গ  :  ক্লিবলিঙ্গ
ক্লিনিক  :  ক্লিনিক
ক্রাব  :  ক্রাব
ক্রয়  :  ক্রয়
ক্রমে  :  ক্রম
ক্রমশ  :  ক্রমশ
ক্রমবিকাশের  :  ক্রমবিকাশ
ক্রমবর্ধমান  :  ক্রমবর্ধমান
ক্যালকোলিথিক  :  ক্যালকোলিথিক
ক্যাম্প  :  ক্যাম্প
ক্যামিস্ট  :  ক্যামিস্ট
ক্যান্টন  :  ক্যান্টন
ক্যানিং  :  ক্যানিং
ক্যানটন  :  ক্যানটন
কৌশলের  :  কৌশল
কৌশলগত  :  কৌশলগত
কৌশম্বির  :  কৌশম্বি
কৌণিক  :  কৌণিক
কোলের  :  কোল
কোলেকে  :  কোলেড
কোলাদানের  :  কোলাদান
কোলকাতায়  :  কোলকাতায়
কোর্স  :  কোর্স
কোর্টের  :  কোর্ট
কোর্গসহ  :  কোর্গসহ
কোর্গ  :  কোর্গ
কোনোরূপ  :  কোনোরূপ
কোনোভাবে  :  কোনোভাব
কোনোটি  :  কোন
কোনোখানে  :  কোনোখান
কোট্টপাল  :  কোট্টপাল
কোট্ট  :  কোট্ট
কোটেরপাড়  :  কোটেরপাড়
কোটের  :  কোট
কোটবাড়ি  :  কোটবাড়ি
কেন্দ্রিক  :  কেন্দ্রিক
কেন্দ্রগুলিরও  :  কেন্দ্রগুলিরও
কেনা  :  কেনা
কৃষ্ণা  :  কৃষ্ণা
কৃষিভূমির  :  কৃষিভূমি
কৃষক  :  কৃষক
কৃতকর্মের  :  কৃতকর্ম
কূপে  :  কূপ
কুসেঁ  :  কুসেঁ
কুরআনের  :  কুরআন
কুমিল্লা  :  কুমিল্লা
কুমার  :  কুমা
কুতব  :  কুতব
কুটিরশিল্প  :  কুটিরশিল্প
কীর্তিস্তম্ভকে  :  কীর্তিস্তম্ভড
কীর্তি  :  কীর্তি
কিশোরগঞ্জের  :  কিশোরগঞ্জ
কিরাআ  :  কিরাআ
কিয়াকটও  :  কিয়াকটও
কিয়াউকপিউ  :  কিয়াউকপিউ
কিমি  :  কিমি
কিভাবে  :  কিভাব
কিথ  :  কিথ
কাহিনীর  :  কাহিনী
কাহিনী  :  কাহিনী
কাশ্মীর  :  কাশ্মী
কালের  :  কাল
কালে  :  কাল
কালীমন্দিরও  :  কালীমন্দিরও
কালীবাড়ি  :  কালীবাড়ি
কালসি  :  কালসি
কার্যালয়সমূহের  :  কার্যালয়সমূহ
কার্যালয়  :  কার্যালয়
কার্যাবলির  :  কার্যাবলি
কার্যক্রমে  :  কার্যক্রম
কার্যকারিতা  :  কার্যকারিতা
কার্ড  :  কার্ড
কার্জনের  :  কার্জন
কার্জন  :  কার্জন
কারো  :  কার
কারীম  :  কারীম
কারিগর  :  কারিগ
কারাদন্ড  :  কারাদন্ড
কারণেও  :  কারণেও
কারখানা  :  কার
কায়েম  :  কায়েম
কামিল  :  কামিল
কামানঞ্চিদের  :  কামানঞ্চি
কামাঞ্চি  :  কামাঞ্চি
কামরাঙ্গীচরে  :  কামরাঙ্গীচর
কামরাঙ্গিরচর  :  কামরাঙ্গিরচ
কাব্য  :  কাব্য
কাপড়  :  কাপড়
কানুন  :  কানুন
কাতাবা  :  কাতাবা
কাঠিরহাট  :  কাঠিরহাট
কাঠামোর  :  কাঠাম
কাঠামোগত  :  কাঠামোগত
কাজেরই  :  কাজেরই
কাজটি  :  কাজ
কাজকে  :  কাজড
কাঁসর  :  কাঁস
কাঁথি  :  কাঁথি
কাঁঠাল  :  কাঁঠাল
কাঁচামাল  :  কাঁচামাল
কাঁচ  :  কাঁচ
কলেজেই  :  কলেজেই
কলেজিয়েট  :  কলেজিয়েট
কর্মসূচির  :  কর্মসূচি
কর্মচারীদের  :  কর্মচারী
কর্পূরদীপ  :  কর্পূরদীপ
কর্দমস্তর  :  কর্দমস্ত
কর্দম  :  কর্দম
কর্তৃত্বকে  :  কর্তৃত্বড
কর্তিত  :  কর্তিত
কর্ণাটকের  :  কর্ণাটক
করীম  :  করীম
করারও  :  করারও
করবেল  :  করবেল
করপাস  :  করপাস
করতো  :  করত
কয়েকটিতে  :  কয়েক
কমিটি  :  কমি
কমান্ডার  :  কমান্ডা
কমর  :  কমর
কবিকে  :  কবিড
কবরস্থানগুলি  :  কবরস্থানগুলি
কপি  :  কপি
কন্যা  :  কন্যা
কতৃক  :  কতৃক
কতটা  :  কতটা
কতগুলি  :  কতগুলি
কণা  :  কণা
কঙ্কনদিঘির  :  কঙ্কনদিঘি
কঙ্কনদিঘি  :  কঙ্কনদিঘি
কখনওই  :  কখনওই
কক্সবাজার  :  কক্সবাজা
কক্ষের  :  কক্ষ
কক্ষসমূহ  :  কক্ষসমূহ
কক্ষটি  :  কক্ষ
কওমী  :  কওমী
ওহীদের  :  ওহী
ওলন্দাজ  :  ওলন্দাজ
ওরফে  :  ওরফ
ওযিফা  :  ওযিফা
ওয়েস্টম্যাকট  :  ওয়েস্টম্যাকট
ওয়েলেসলির  :  ওয়েলেসলি
ওয়ারেন  :  ওয়ারেন
ওয়ারী  :  ওয়ারী
ওয়াজিব  :  ওয়াজিব
ওবায়দুল্লাহ  :  ওবায়দুল্লাহ
ওবায়দী  :  ওবায়দী
ওপরের  :  ওপর
ওপরও  :  ওপরও
ওজন  :  ওজন
ঐশ্বর্যশালী  :  ঐশ্বর্যশালী
ঐতিহ্যগত  :  ঐতিহ্যগত
ঐতিহাসিকভাবে  :  ঐতিহাসিকভাব
এসেছিল  :  এসেছিল
এসময়  :  এসময়
এসটি  :  এসটি
এসএমএস  :  এসএমএস
এলাকাতেই  :  এলাকাতেই
এলাকাটি  :  এলাকা
এরমধ্যে  :  এরমধ্য
এরও  :  এরও
এযুগের  :  এযুগ
এযুগে  :  এযুগ
এমনটি  :  এমন
এবাদুল  :  এবাদুল
এপিগ্রাফিকা  :  এপিগ্রাফিকা
এন্টিকয়ারি  :  এন্টিকয়ারি
এড়িয়ে  :  এড়িয়
এটিকে  :  এটিড
এটিএম  :  এটিএম
এজেন্সী  :  এজেন্সী
এগিয়ে  :  এগিয়
এখানকার  :  এখানকা
এখান  :  এখান
এক্সকাভেশন  :  এক্সকাভেশন
একাধারে  :  একাধার
একসময়  :  একসময়
একশিলা  :  একশিলা
একবচন  :  একবচন
একপক্ষ  :  একপক্ষ
একদিনের  :  একদিন
একদিকে  :  একদিড
একজনের  :  একজন
এককালে  :  এককাল
এককভাবে  :  এককভাব
একইরূপ  :  একইরূপ
ঋণসহ  :  ঋণসহ
ঋণবিতরণ  :  ঋণবিতরণ
উৎসাহ  :  উৎসাহ
উৎসর্গীকৃত  :  উৎসর্গীকৃত
উৎপাদনের  :  উৎপাদন
উৎখননসমূহের  :  উৎখননসমূহ
উৎকৃষ্টমানের  :  উৎকৃষ্টমান
উৎকর্ষ  :  উৎকর্ষ
উল্লেখ্য  :  উল্লেখ্য
উল্লম্বভাবে  :  উল্লম্বভাব
উলেখযোগ্য  :  উলেখযোগ্য
উলেকে  :  উলেড
উলামা  :  উলামা
উলা  :  উলা
উর্বর  :  উর্ব
উযু  :  উযু
উভয়ের  :  উভয়
উভয়ই  :  উভয়ই
উপায়ে  :  উপায়
উপস্থিতি  :  উপস্থিতি
উপস্থাপনে  :  উপস্থাপন
উপস্থাপন  :  উপস্থাপন
উপসাগর  :  উপসাগ
উপশহর  :  উপশহ
উপলব্ধি  :  উপলব্ধি
উপরিস্থিত  :  উপরিস্থিত
উপরিকাঠামোর  :  উপরিকাঠাম
উপরিকাঠামোটি  :  উপরিকাঠাম
উপরিকাঠামো  :  উপরিকাঠাম
উপরন্তু  :  উপরন্তু
উপরন্ত  :  উপরন্ত
উপমাদেশেও  :  উপমাদেশেও
উপমহাদেশে  :  উপমহাদেশ
উপমহাদেশ  :  উপমহাদেশ
উপভাষার  :  উপভাষা
উপনীত  :  উপনীত
উপদ্বীপ  :  উপদ্বীপ
উপত্যকার  :  উপত্যকা
উপজীব্য  :  উপজীব্য
উপজাতীয়  :  উপজাতীয়
উপজাতি  :  উপজাতি
উপকূলের  :  উপকূল
উপকূলেও  :  উপকূলেও
উপকরণগুলি  :  উপকরণগুলি
উপ  :  উপ
উন্মোচনে  :  উন্মোচন
উন্মোচন  :  উন্মোচন
উন্মুক্ত  :  উন্মুক্ত
উন্নীত  :  উন্নীত
উন্নতি  :  উন্নতি
উদ্যোগ  :  উদ্যোগ
উদ্যোক্তার  :  উদ্যোক্তা
উদ্যোক্তা  :  উদ্যোক্তা
উদ্যানতত্ত্বের  :  উদ্যানতত্ত্ব
উদ্যানতত্ত্বকে  :  উদ্যানতত্ত্বড
উদ্ভাবনে  :  উদ্ভাবন
উদ্ধারে  :  উদ্ধার
উদ্ধার  :  উদ্ধা
উদ্দেশ্য  :  উদ্দেশ্য
উদ্ঘাটনলপ্রভৃতি  :  উদ্ঘাটনলপ্রভৃতি
উদ্  :  উদ্
উদীয়মান  :  উদীয়মান
উদাহরণস্বরূপ  :  উদাহরণস্বরূপ
উত্থাপিত  :  উত্থাপিত
উত্থাপন  :  উত্থাপন
উত্তোলনযোগ্য  :  উত্তোলনযোগ্য
উত্তেজনা  :  উত্তেজনা
উত্তরে  :  উত্তর
উত্তরবঙ্গের  :  উত্তরবঙ্গ
উত্তরকালে  :  উত্তরকাল
উত্তম  :  উত্তম
উড়িষ্যা  :  উড়িষ্যা
উড়িয়ে  :  উড়িয়
উঠানামার  :  উঠানামা
উজ্জ্বল  :  উজ্জ্বল
উজির  :  উজি
উচ্চারণে  :  উচ্চারণ
উচ্চারণ  :  উচ্চারণ
উচ্চশিক্ষার  :  উচ্চশিক্ষা
উচ্চতাবিশিষ্ট  :  উচ্চতাবিশিষ্ট
উচ্চতা  :  উচ্চতা
উচ্চতর  :  উচ্চত
উচ্চতম  :  উচ্চতম
উচিতপুর  :  উচিতপু
উইলিয়ম  :  উইলিয়ম
উঁচু  :  উঁচু
ঈমান  :  ঈমান
ইস্টার্ণ  :  ইস্টার্ণ
ইসলামি  :  ইসলামি
ইলমুল  :  ইলমুল
ইয়োমা  :  ইয়োমা
ইয়াহিয়া  :  ইয়াহিয়া
ইয়াক্কা  :  ইয়াক্কা
ইয়া  :  ইয়া
ইমারতই  :  ইমারতই
ইমদাদিয়া  :  ইমদাদিয়া
ইব্ন  :  ইব্ন
ইপিগ্রাফিক্যাল  :  ইপিগ্রাফিক্যাল
ইন্সক্রিপশনাম  :  ইন্সক্রিপশনাম
ইন্দ্রজির  :  ইন্দ্রজি
ইন্ডিকারাম  :  ইন্ডিকারাম
ইন্ডিকা  :  ইন্ডিকা
ইন্টারনেট  :  ইন্টারনেট
ইনকর্পোরেটেড  :  ইনকর্পোরেটেড
ইত্যাদিও  :  ইত্যাদিও
ইতিহাস্ল  :  ইতিহাস্ল
ইতিহাসবেত্তা  :  ইতিহাসবেত্তা
ইতিহাসকে  :  ইতিহাসড
ইটাখোলামুড়া  :  ইটাখোলামুড়া
ইটাখোলা  :  ইটাখোলা
ইঞ্জিনিয়ার্সের  :  ইঞ্জিনিয়ার্স
ইগেলিং  :  ইগেলিং
ইউরোপে  :  ইউরোপ
ইউনাইটেড  :  ইউনাইটেড
ইংরেজিকেও  :  ইংরেজিকেও
ইংরেজরা  :  ইংরেজর
ইংরেজদের  :  ইংরেজ
আহবান  :  আহবান
আস্তর  :  আস্ত
আসার  :  আসা
আসলে  :  আসল
আস  :  আস
আশেপাশে  :  আশেপাশ
আশে  :  আশে
আশরফপুরের  :  আশরফপুর
আল্লামা  :  আল্লামা
আলোচনাপূর্বক  :  আলোচনাপূর্বক
আলোকে  :  আলোড
আলোকপাত  :  আলোকপাত
আলেম  :  আলেম
আলেকজান্দ্রিয়া  :  আলেকজান্দ্রিয়া
আলু  :  আলু
আলী  :  আলী
আলিম  :  আলিম
আলাদাভাবে  :  আলাদাভাব
আলাউদ্দীন  :  আলাউদ্দীন
আলমের  :  আলম
আর্সেনিকের  :  আর্সেনিক
আর্ন্তজাতিক  :  আর্ন্তজাতিক
আর্থিক  :  আর্থিক
আর্কিওলজি  :  আর্কিওলজি
আরোও  :  আরোও
আরো  :  আরো
আরেক  :  আরেক
আরিকামেদু  :  আরিকামেদু
আরাকানরা  :  আরাকানর
আরাকানকে  :  আরাকানড
আরবে  :  আরব
আরবরা  :  আরবর
আরবদেশ  :  আরবদেশ
আরবদেরকে  :  আরব
আরবগণ  :  আরবগণ
আরতি  :  আরতি
আয়ের  :  আয়
আয়ত্বে  :  আয়ত্ব
আয়তন  :  আয়তন
আম্রপল্লব  :  আম্রপল্লব
আম্মা  :  আম্মা
আমানত  :  আমানত
আমলে  :  আমল
আমন্ত্রণ  :  আমন্ত্রণ
আমদানি  :  আমদা
আম  :  আম
আবেদনের  :  আবেদন
আবেদনে  :  আবেদন
আবেদনক্রমে  :  আবেদনক্রম
আবৃত  :  আবৃত
আবুতাওয়ামা  :  আবুতাওয়ামা
আবিসিনিয়ান  :  আবিসিনিয়ান
আবিষ্কারের  :  আবিষ্কার
আবিষ্কারে  :  আবিষ্কার
আবির্ভাবের  :  আবির্ভাব
আবির্ভাব  :  আবির্ভাব
আবাসনের  :  আবাসন
আবাসনও  :  আবাসনও
আববাস  :  আববাস
আববা  :  আববা
আবগারী  :  আবগারী
আপ্যায়ন  :  আপ্যায়ন
আপোস  :  আপোস
আন্দোলনের  :  আন্দোলন
আন্তঃসংযোগসম্পন্ন  :  আন্তঃসংযোগসম্পন্ন
আনে  :  আনে
আনতে  :  আনত
আদেশের  :  আদেশ
আদিবাসী  :  আদিবাসী
আদিনাথ  :  আদিনাথ
আদায়ের  :  আদায়
আদায়  :  আদায়
আদলে  :  আদল
আদর্শ  :  আদর্শ
আদম  :  আদম
আত্মনিবেদিত  :  আত্মনিবেদিত
আড়াআড়িভাবে  :  আড়াআড়িভাব
আড়ত  :  আড়ত
আঠারো  :  আঠার
আটি  :  আটি
আটক  :  আটক
আছেন  :  আছেন
আচ্ছাদিত  :  আচ্ছাদিত
আঙ্গিনায়  :  আঙ্গিনায়
আগ্রায়  :  আগ্রায়
আগ্রহ  :  আগ্রহ
আগুনে  :  আগুন
আগুইবাড়ি  :  আগুইবাড়ি
আগলী  :  আগলী
আগত  :  আগত
আগ  :  আগ
আকৃতির  :  আকৃতি
আকিয়াব  :  আকিয়াব
আকিদাহ  :  আকিদাহ
আকর্ষণীয়  :  আকর্ষণীয়
আওরঙ্গজেব  :  আওরঙ্গজেব
আউলিয়াদের  :  আউলিয়া
আইনসমূহ  :  আইনসমূহ
আইনজীবী  :  আইনজীবী
আইএ  :  আইএ
অ্যাসেসর  :  অ্যাসেস
অ্যান্টিকুইটি  :  অ্যান্টিকুই
অ্যাক্ট  :  অ্যাক্ট
অহিচছাত্রায়  :  অহিচছাত্রায়
অহিচছাত্রা  :  অহিচছাত্র
অস্থিতিশীল  :  অস্থিতিশীল
অস্থায়ী  :  অস্থায়ী
অসহযোগিতার  :  অসহযোগিতা
অসম্পূর্ণ  :  অসম্পূর্ণ
অসদাচরণ  :  অসদাচরণ
অষ্টম  :  অষ্টম
অল্পদিনের  :  অল্পদিন
অলি  :  অলি
অলঙ্কার  :  অলঙ্কা
অলঙ্করণে  :  অলঙ্করণ
অলংকৃত  :  অলংকৃত
অলংকার  :  অলংকা
অর্পিত  :  অর্পিত
অর্পণ  :  অর্পণ
অর্ধেক  :  অর্ধেক
অর্ধাবদ্ধ  :  অর্ধাবদ্ধ
অর্ধ  :  অর্ধ
অর্থে  :  অর্থ
অর্জনের  :  অর্জন
অর্গিল  :  অর্গিল
অর্কা  :  অর্কা
অযোধ্যার  :  অযোধ্যা
অমুসলিমরাও  :  অমুসলিমরাও
অভ্যস্ত  :  অভ্যস্ত
অভ্যন্তরস্থ  :  অভ্যন্তরস্থ
অভূতপূর্ব  :  অভূতপূর্ব
অভিহিত  :  অভিহিত
অভিসন্দর্ভসমূহের  :  অভিসন্দর্ভসমূহ
অভিলেখনের  :  অভিলেখন
অভিলিখনের  :  অভিলিখন
অভিবাসী  :  অভিবাসী
অভিবাসিত  :  অভিবাসিত
অভিবাসন  :  অভিবাসন
অভাবে  :  অভাব
অভাব  :  অভাব
অব্যয়  :  অব্যয়
অবৈতনিক  :  অবৈতনিক
অবস্থিতি  :  অবস্থিতি
অবস্থায়  :  অবস্থায়
অবস্থানের  :  অবস্থান
অবস্থাতেই  :  অবস্থাতেই
অবশ্যপালনীয়  :  অবশ্যপালনীয়
অবলোকিতেশ্বরের  :  অবলোকিতেশ্বর
অবয়বের  :  অবয়ব
অবদানের  :  অবদান
অবকাঠামো  :  অবকাঠাম
অপ্রতুল  :  অপ্রতুল
অপেক্ষা  :  অপেক্ষা
অপরিহার্য  :  অপরিহার্য
অপভ্রংশ  :  অপভ্রংশ
অন্যায়  :  অন্যায়
অন্যান্যরা  :  অন্যান্যর
অন্যান্যদের  :  অন্যান্য
অন্যভাগ  :  অন্যভাগ
অন্যত্র  :  অন্যত্
অন্যটি  :  অন্য
অন্বেষণে  :  অন্বেষণ
অন্বেষণ  :  অন্বেষণ
অন্তর্বর্তী  :  অন্তর্বর্তী
অনেকগুলি  :  অনেকগুলি
অনেককেই  :  অনেককেই
অনেককাল  :  অনেককাল
অনুসরণে  :  অনুসরণ
অনুসন্ধানকারী  :  অনুসন্ধানকারী
অনুষ্ঠিত  :  অনুষ্ঠিত
অনুলিয়া  :  অনুলিয়া
অনুরোধে  :  অনুরোধ
অনুরোধ  :  অনুরোধ
অনুযায়ীও  :  অনুযায়ীও
অনুমোদনের  :  অনুমোদন
অনুমোদনক্রমে  :  অনুমোদনক্রম
অনুমানিক  :  অনুমানিক
অনুমানলব্ধ  :  অনুমানলব্ধ
অনুমান  :  অনুমান
অনুভূমিকভাবে  :  অনুভূমিকভাব
অনুবাদ  :  অনুবাদ
অনুপস্থিতিতে  :  অনুপস্থিতি
অনুপস্থিত  :  অনুপস্থিত
অনুচিত  :  অনুচিত
অনুকপি  :  অনুকপি
অনীস  :  অনীস
অনানুষ্ঠানিকভাবে  :  অনানুষ্ঠানিকভাব
অধ্যাপনা  :  অধ্যাপনা
অধ্যাপক  :  অধ্যাপক
অধুনা  :  অধুনা
অধিবাসীর  :  অধিবাসী
অধিবাসী  :  অধিবাসী
অধিপতি  :  অধিপতি
অধিদপ্তর  :  অধিদপ্ত
অধিকারী  :  অধিকারী
অধিকতর  :  অধিকত
অত্যুৎসাহী  :  অত্যুৎসাহী
অত্যধিক  :  অত্যধিক
অতীতের  :  অতীত
অতিসম্প্রতি  :  অতিসম্প্রতি
অতিথি  :  অতিথি
অতঃপর  :  অতঃপ
অট্টণালিকাসমূহের  :  অট্টণালিকাসমূহ
অঞ্জলিকা  :  অঞ্জলিকা
অঞ্চলেরই  :  অঞ্চলেরই
অঞ্চলটি  :  অঞ্চল
অঙ্গরাজ্য  :  অঙ্গরাজ্য
অঙ্গবিশেষ  :  অঙ্গবিশেষ
অঙ্গনে  :  অঙ্গন
অঙ্কিত  :  অঙ্কিত
অঙ্কন  :  অঙ্কন
অগ্রাধিকার  :  অগ্রাধিকা
অগ্রভাগ  :  অগ্রভাগ
অগ্রগতি  :  অগ্রগতি
অগভীর  :  অগভী
অখোদিত  :  অখোদিত
অক্ষাংশ  :  অক্ষাংশ
অক্ষয়কুমার  :  অক্ষয়কুমা
অক্ষদন্ড  :  অক্ষদন্ড
অক্লান্তভাবে  :  অক্লান্তভাব
অক্লান্ত  :  অক্লান্ত
অক্টোবর  :  অক্টোব
অংশবিশেষ  :  অংশবিশেষ
অংশটি  :  অংশ
অংকশাস্ত্র  :  অংকশাস্ত্
﻿এবং  :  ﻿এবং
হয়  :  হয়
করা  :  করা
সালে  :  সাল
পাওয়া  :  পাওয়া
যায়  :  যায়
আরবি  :  আরবি
হয়েছে  :  হয়েছ
রয়েছে  :  রয়েছ
প্রাচীন  :  প্রাচীন
সালের  :  সাল
হিসেবে  :  হিসেব
আইন  :  আইন
প্রাপ্ত  :  প্রাপ্ত
কাজ  :  কাজ
বাংলাদেশের  :  বাংলাদেশ
কোন  :  কোন
হতো  :  হতো
দক্ষিণ  :  দক্ষিণ
হচ্ছে  :  হচ্ছ
তৈরি  :  তৈরি
সরকার  :  সরকা
বিহার  :  বিহা
প্রধান  :  প্রধান
সংরক্ষণ  :  সংরক্ষণ
তবে  :  তবে
গেছে  :  গেছ
প্রত্নতাত্ত্বিক  :  প্রত্নতাত্ত্বিক
গুরুত্বপূর্ণ  :  গুরুত্বপূর্ণ
উত্তর  :  উত্ত
অঞ্চলের  :  অঞ্চল
বৌদ্ধ  :  বৌদ্ধ
ধারা  :  ধারা
উৎখনন  :  উৎখনন
মাদ্রাসা  :  মাদ্রাসা
অঞ্চলে  :  অঞ্চল
নামে  :  নাম
খনন  :  খনন
আর্কিওলজিক্যাল  :  আর্কিওলজিক্যাল
হয়েছিল  :  হয়েছিল
হতে  :  হতে
মুসলিম  :  মুসলিম
বিভিন্ন  :  বিভিন্ন
নতুন  :  নতুন
তাদের  :  তাদ
অঞ্চল  :  অঞ্চল
ভূগর্ভস্থ  :  ভূগর্ভস্থ
জেলার  :  জেলা
উৎকীর্ণ  :  উৎকীর্ণ
হয়ে  :  হয়
মূর্তি  :  মূর্তি
মুদ্রা  :  মুদ্র
বলে  :  বলে
প্রথম  :  প্রথম
দেওয়া  :  দেওয়া
ঐতিহাসিক  :  ঐতিহাসিক
অন্যান্য  :  অন্যান্য
অনুসন্ধান  :  অনুসন্ধান
সময়  :  সময়
শুরু  :  শুরু
নির্মিত  :  নির্মিত
নিদর্শন  :  নিদর্শন
কাজের  :  কাজ
প্রায়  :  প্রায়
পূর্ব  :  পূর্ব
নয়  :  নয়
জলস্তর  :  জলস্ত
চট্টগ্রাম  :  চট্টগ্রাম
গ্রহণ  :  গ্রহণ
গিয়েছে  :  গিয়েছ
একজন  :  একজন
অব  :  অব
সরকারের  :  সরকার
যুগের  :  যুগ
মন্দির  :  মন্দি
বাংলার  :  বাংলা
বাংলাদেশে  :  বাংলাদেশ
বাংলাদেশ  :  বাংলাদেশ
প্রত্নতত্ত্ব  :  প্রত্নতত্ত্ব
পোড়ামাটির  :  পোড়ামা
দ্বারা  :  দ্বার
জরিপ  :  জরিপ
কেন্দ্রীয়  :  কেন্দ্রীয়
এগুলি  :  এগুলি
অনুযায়ী  :  অনুযায়ী
যদি  :  যদি
প্রতিষ্ঠিত  :  প্রতিষ্ঠিত
প্রকাশ  :  প্রকাশ
নি  :  নি
ধরনের  :  ধরন
এক  :  এক
অবস্থিত  :  অবস্থিত
স্থানে  :  স্থান
সৃষ্টি  :  সৃষ্
সার্ভে  :  সার্ভ
সকল  :  সকল
শতক  :  শতক
ফলক  :  ফলক
প্রত্নস্থল  :  প্রত্নস্থল
প্রত্নবস্ত্ত  :  প্রত্নবস্ত্ত
প্রত্ননিদর্শন  :  প্রত্ননিদর্শন
পাহাড়পুর  :  পাহাড়পু
পশ্চিম  :  পশ্চিম
পরিচালনা  :  পরিচালনা
নিয়োগ  :  নিয়োগ
দেশের  :  দেশ
দিক  :  দিক
উল্লেখযোগ্য  :  উল্লেখযোগ্য
স্মৃতিসৌধ  :  স্মৃতিসৌধ
স্থাপন  :  স্থাপন
সালিশকারী  :  সালিশকারী
সাল  :  সাল
সম্পর্কে  :  সম্পর্ড
লিপি  :  লিপি
বেশি  :  বেশি
পরিচালিত  :  পরিচালিত
নিকট  :  নিকট
ধারণা  :  ধারণা
কর্তৃক  :  কর্তৃক
কয়েকটি  :  কয়েক
হাতিয়ার  :  হাতিয়া
স্থাপত্য  :  স্থাপত্য
সালিশি  :  সালিশি
সম্ভবত  :  সম্ভবত
সংগ্রহ  :  সংগ্রহ
শালবন  :  শালবন
রপ্তানি  :  রপ্তা
যেমন  :  যেমন
যাবে  :  যাব
ময়নামতীর  :  ময়নামতী
ভারতের  :  ভারত
ভারত  :  ভারত
বিষয়ে  :  বিষয়
বিভাগ  :  বিভাগ
বাংলা  :  বাংলা
বর্তমানে  :  বর্তমান
প্রদান  :  প্রদান
পরবর্তী  :  পরবর্তী
নিয়ে  :  নিয়
ধর্মীয়  :  ধর্মীয়
দায়িত্ব  :  দায়িত্ব
ঢাকা  :  ঢাকা
গড়ে  :  গড়
কানিংহাম  :  কানিংহাম
এসব  :  এসব
আরাকানের  :  আরাকান
আরব  :  আরব
হবে  :  হবে
স্থানীয়  :  স্থানীয়
সুপারিন্টেনডেন্ট  :  সুপারিন্টেনডেন্ট
সাংস্কৃতিক  :  সাংস্কৃতিক
সময়ে  :  সময়
শব্দ  :  শব্দ
রাজা  :  রাজা
ভাষা  :  ভাষা
ব্যবহূত  :  ব্যবহূত
বাংলায়  :  বাংলায়
বলা  :  বলা
প্রদেশ  :  প্রদেশ
প্রতিবেদন  :  প্রতিবেদন
পূর্বে  :  পূর্ব
দিয়ে  :  দিয়
দিকে  :  দিক
তিনটি  :  তিন
তমলুক  :  তমলুক
এন  :  এন
ইতিহাসের  :  ইতিহাস
অতি  :  অতি
শুধু  :  শুধু
শতকের  :  শতক
মুড়া  :  মুড়া
ময়নামতী  :  ময়নামতী
বিস্তৃত  :  বিস্তৃত
বিষয়  :  বিষয়
বসতি  :  বসতি
ফলে  :  ফলে
পাথরের  :  পাথর
নিযুক্ত  :  নিযুক্ত
ছাড়া  :  ছাড়া
গ্রন্থ  :  গ্রন্থ
গুরুত্ব  :  গুরুত্ব
খ্রিস্টাব্দে  :  খ্রিস্টাব্দ
ক্ষুদ্র  :  ক্ষুদ্
ক্ষমতা  :  ক্ষমতা
কে  :  কে
কারণে  :  কারণ
এগুলির  :  এগুলি
আদি  :  আদি
সুযোগ  :  সুযোগ
সাথে  :  সাথ
সংরক্ষণের  :  সংরক্ষণ
শিক্ষা  :  শিক্ষা
লাভ  :  লাভ
রোয়েদাদ  :  রোয়েদাদ
মনে  :  মনে
ভাস্কর্য  :  ভাস্কর্য
বছর  :  বছর
পুনরায়  :  পুনরায়
পাহাড়পুরের  :  পাহাড়পুর
পরিচালকের  :  পরিচালক
নানা  :  নানা
তারা  :  তারা
ঢাকার  :  ঢাকা
ছোট  :  ছোট
কার্যক্রম  :  কার্যক্রম
কথা  :  কথা
এলাকায়  :  এলাকায়
এলাকা  :  এলাকা
উল্লেখ  :  উল্লেখ
উন্মোচিত  :  উন্মোচিত
আরাকান  :  আরাকান
আবিষ্কার  :  আবিষ্কা
আড়াইহাজার  :  আড়াইহাজা
আকারের  :  আকার
অনুসরণ  :  অনুসরণ
অধীনে  :  অধীন
অধীন  :  অধীন
হয়নি  :  হয়
স্থান  :  স্থান
স্তর  :  স্ত
সোসাইটি  :  সোসাই
সিদ্ধান্ত  :  সিদ্ধান্ত
সহকারী  :  সহকারী
সরকারি  :  সরকারি
সংশ্লিষ্ট  :  সংশ্লিষ্ট
শাহ  :  শাহ
শতকে  :  শতক
রীতির  :  রীতি
রিপোর্ট  :  রিপোর্ট
রাজনৈতিক  :  রাজনৈতিক
যোগাযোগ  :  যোগাযোগ
যেকোন  :  যেকোন
মূর্তির  :  মূর্তি
ভাসু  :  ভাসু
ভাষায়  :  ভাষায়
ব্রোঞ্জ  :  ব্রোঞ্জ
বিহারে  :  বিহার
বিশিষ্ট  :  বিশিষ্ট
বিলুপ্ত  :  বিলুপ্ত
বিভাগের  :  বিভাগ
বর্তমান  :  বর্তমান
বরেন্দ্র  :  বরেন্দ্
বন্ধ  :  বন্ধ
বন্দর  :  বন্দ
বড়  :  বড়
ফসিল  :  ফসিল
প্রস্তাব  :  প্রস্তাব
প্রভৃতি  :  প্রভৃতি
প্রণীত  :  প্রণীত
প্রকাশিত  :  প্রকাশিত
পাকিস্তান  :  পাকিস্তান
পর্যাপ্ত  :  পর্যাপ্ত
পদ  :  পদ
নাম  :  নাম
দুই  :  দুই
তথ্য  :  তথ্য
তখন  :  তখন
জাহাঙ্গীরনগর  :  জাহাঙ্গীরনগ
চবিবশ  :  চবিবশ
গুপ্ত  :  গুপ্ত
গবেষণা  :  গবেষণা
গঠিত  :  গঠিত
কুরআন  :  কুরআন
উভয়  :  উভয়
ইসলাম  :  ইসলাম
আবিষ্কৃত  :  আবিষ্কৃত
আইনের  :  আইন
অবশ্য  :  অবশ্য
অধিকাংশ  :  অধিকাংশ
অংশ  :  অংশ
হাতে  :  হাত
হওয়ার  :  হওয়া
সি  :  সি
সাহিত্য  :  সাহিত্য
সাম্প্রতিক  :  সাম্প্রতিক
সাধারণ  :  সাধারণ
সরকারকে  :  সরকারড
সবচেয়ে  :  সবচেয়
সংরক্ষিত  :  সংরক্ষিত
সংক্রান্ত  :  সংক্রান্ত
শেষ  :  শেষ
শিক্ষার  :  শিক্ষা
শাখা  :  শাখা
শহর  :  শহর
শব্দের  :  শব্
শনাক্ত  :  শনাক্ত
লর্ড  :  লর্ড
রোহিঙ্গ্যা  :  রোহিঙ্গ্যা
যুক্ত  :  যুক্ত
মিলিয়ন  :  মিলিয়ন
মিটার  :  মিটা
মাটির  :  মাটি
মহাস্থান  :  মহাস্থান
মহা  :  মহা
মধ্যযুগের  :  মধ্যযুগ
মঠ  :  মঠ
ভারতীয়  :  ভারতীয়
ব্রোঞ্জের  :  ব্রোঞ্জ
ব্রিটিশ  :  ব্রিটিশ
ব্যাপক  :  ব্যাপক
ব্যাংক  :  ব্যাংক
ব্যবস্থা  :  ব্যবস্থা
বিস্তারিত  :  বিস্তারিত
বিশ্ববিদ্যালয়ের  :  বিশ্ববিদ্যালয়
বিবদমান  :  বিবদমান
বার্মা  :  বার্মা
বার্জেস  :  বার্জেস
বাতিল  :  বাতিল
বাজার  :  বাজা
বছরের  :  বছর
প্রাথমিক  :  প্রাথমিক
প্রমাণ  :  প্রমাণ
পাহাড়পুরে  :  পাহাড়পুর
পাল  :  পাল
পাঞ্জাব  :  পাঞ্জাব
পর্যায়ে  :  পর্যায়
পরিবর্তন  :  পরিবর্তন
পরিকল্পনা  :  পরিকল্পনা
পদে  :  পদে
নির্দেশ  :  নির্দেশ
নামক  :  নামক
দেশে  :  দেশ
দেখা  :  দেখা
দুর্গ  :  দুর্গ
তিন  :  তিন
ডাইরেক্টর  :  ডাইরেক্ট
জানা  :  জানা
চারপত্র  :  চারপত্
কাল  :  কাল
কার্য  :  কার্য
করেছে  :  করেছ
কয়েক  :  কয়েক
ওপর  :  ওপর
এগুলোর  :  এগুল
একক  :  একক
উয়ারী  :  উয়ারী
উন্নত  :  উন্নত
উদ্যোগে  :  উদ্যোগ
ইন্ডিয়ার  :  ইন্ডিয়া
আরাকানে  :  আরাকান
আরবিতে  :  আরবি
অস্তিত্ব  :  অস্তিত্ব
অর্থাৎ  :  অর্থাৎ
অন্তর্ভুক্ত  :  অন্তর্ভুক্ত
অধিকাংশই  :  অধিকাংশই
স্যার  :  স্যা
স্বাধীনতা  :  স্বাধীনতা
সেখানে  :  সেখান
সুপারিশ  :  সুপারিশ
সুপরিচিত  :  সুপরিচিত
সার্ভের  :  সার্ভ
সময়ের  :  সময়
সমগ্র  :  সমগ্
সংস্কৃত  :  সংস্কৃত
সংযুক্ত  :  সংযুক্ত
সংখ্যা  :  সংখ্যা
সংখ্যক  :  সংখ্যক
লিপির  :  লিপি
রৌপ্য  :  রৌপ্য
রিসার্চ  :  রিসার্চ
রায়  :  রায়
রচনা  :  রচনা
র  :  র
যৌথ  :  যৌথ
যুগে  :  যুগ
মাদ্রাসার  :  মাদ্রাসা
মাইল  :  মাইল
মসজিদ  :  মসজিদ
ময়নামতীতে  :  ময়নামতী
মধ্য  :  মধ্য
ভ্রমণ  :  ভ্রমণ
ভূমিকা  :  ভূমিকা
ভূ  :  ভূ
ভাষার  :  ভাষা
ব্যাংকের  :  ব্যাংক
ব্যতীত  :  ব্যতীত
ব্যক্তি  :  ব্যক্তি
বৃহত্তর  :  বৃহত্ত
বৃক্ষবিদ্যা  :  বৃক্ষবিদ্যা
বিহারের  :  বিহার
বিশ্ববিদ্যালয়  :  বিশ্ববিদ্যালয়
বিদেশী  :  বিদেশী
বালি  :  বালি
বানিজ্যিক  :  বানিজ্যিক
বটেশ্বর  :  বটেশ্ব
ফলকে  :  ফলক
প্রাদেশিক  :  প্রাদেশিক
প্রত্নস্থলের  :  প্রত্নস্থল
প্রত্নতত্ত্বের  :  প্রত্নতত্ত্ব
প্রতিষ্ঠার  :  প্রতিষ্ঠা
প্রতিষ্ঠান  :  প্রতিষ্ঠান
প্রতিটি  :  প্রতি
পূর্ণ  :  পূর্ণ
পুরুষ  :  পুরুষ
পালন  :  পালন
পারেন  :  পারেন
পাথুরে  :  পাথুর
পশ্চিমে  :  পশ্চিম
পরিমাণ  :  পরিমাণ
পরিচিত  :  পরিচিত
পরিচালক  :  পরিচালক
নির্মাণ  :  নির্মাণ
নিজস্ব  :  নিজস্ব
নদীর  :  নদী
ধ্বংসাবশেষের  :  ধ্বংসাবশেষ
ধ্বংসাবশেষ  :  ধ্বংসাবশেষ
ধর্ম  :  ধর্ম
দ্বিতীয়  :  দ্বিতীয়
দেব  :  দেব
দৃশ্য  :  দৃশ্য
দক্ষিণে  :  দক্ষিণ
থেকেই  :  থেকেই
ঢিবি  :  ঢিবি
ট্রেজার  :  ট্রেজা
জলবাহী  :  জলবাহী
জরিপের  :  জরিপ
ছাঁচে  :  ছাঁচ
চালু  :  চালু
চর্চার  :  চর্চা
চন্দ্রকেতুগড়  :  চন্দ্রকেতুগড়
ঘোষণা  :  ঘোষণা
গৃহীত  :  গৃহীত
গিয়েছিল  :  গিয়েছিল
খান  :  খান
কুটিলা  :  কুটিলা
কার্যকর  :  কার্যক
কাঠের  :  কাঠ
কলকাতা  :  কলকাতা
করেছিল  :  করেছিল
কম  :  কম
কক্ষ  :  কক্ষ
এছাড়া  :  এছাড়া
উদাহরণ  :  উদাহরণ
ইমারত  :  ইমারত
ই  :  ই
আলেকজান্ডার  :  আলেকজান্ডা
আল  :  আল
আরাকানি  :  আরাকা
আরবদের  :  আরব
আন্তর্জাতিক  :  আন্তর্জাতিক
আনা  :  আনা
অর্থনৈতিক  :  অর্থনৈতিক
অব্যাহত  :  অব্যাহত
অনুমোদন  :  অনুমোদন
অধিগ্রহণ  :  অধিগ্রহণ
অত্যন্ত  :  অত্যন্ত
অতিরিক্ত  :  অতিরিক্ত
হিন্দু  :  হিন্দু
হিউয়েন  :  হিউয়েন
হরিনারায়ণপুর  :  হরিনারায়ণপু
স্পষ্ট  :  স্পষ্ট
স্থলে  :  স্থল
সেন  :  সেন
সূক্ষ্ম  :  সূক্ষ্ম
সুলতান  :  সুলতান
সিন্ধু  :  সিন্ধু
সাধিত  :  সাধিত
সাধারণত  :  সাধারণত
সাধন  :  সাধন
সাত  :  সাত
সাং  :  সাং
সম্বলিত  :  সম্বলিত
সম্পর্কিত  :  সম্পর্কিত
সম্পর্ক  :  সম্পর্ক
সমুদ্র  :  সমুদ্
সমিতি  :  সমিতি
সংস্কৃতির  :  সংস্কৃতি
সংশোধন  :  সংশোধন
শেষে  :  শেষ
শাসনামলে  :  শাসনামল
শায়খ  :  শায়খ
শহীদ  :  শহীদ
শহরের  :  শহর
শব্দটি  :  শব্দ
লিপিবিদ  :  লিপিবিদ
লক্ষ্যে  :  লক্ষ্য
রূপবান  :  রূপবান
রিপোর্টটি  :  রিপোর্ট
রাজশাহীর  :  রাজশাহী
রচিত  :  রচিত
যৌগিক  :  যৌগিক
মৌর্য  :  মৌর্য
মৃত্যু  :  মৃত্যু
মূল্যবান  :  মূল্যবান
মূলত  :  মূলত
মূল  :  মূল
মুসলমানদের  :  মুসলমান
মুড়ায়  :  মুড়ায়
মুক্তিযোদ্ধারা  :  মুক্তিযোদ্ধার
মাসে  :  মাস
মানের  :  মান
মাদ্রাজ  :  মাদ্রাজ
মাঝে  :  মাঝ
মাঝ  :  মাঝ
মসৃণ  :  মসৃণ
মন্দিরটি  :  মন্দির
মকতব  :  মকতব
ভিত্তিতে  :  ভিত্তি
ভারতে  :  ভার
ব্যাকরণ  :  ব্যাকরণ
ব্যাংকটির  :  ব্যাংক
ব্যবসায়ী  :  ব্যবসায়ী
বোম্বে  :  বোম্ব
বৈশিষ্ট্য  :  বৈশিষ্ট্য
বেসরকারি  :  বেসরকারি
বেঙ্গল  :  বেঙ্গল
বিরোধ  :  বিরোধ
বিদেশি  :  বিদেশি
বিজ্ঞান  :  বিজ্ঞান
বিচ্ছিন্ন  :  বিচ্ছিন্ন
বিখ্যাত  :  বিখ্যাত
বিকাশ  :  বিকাশ
বি  :  বি
বাণিজ্যের  :  বাণিজ্য
বাণিজ্যিক  :  বাণিজ্যিক
প্রাণী  :  প্রাণী
প্রয়োজন  :  প্রয়োজন
প্রদত্ত  :  প্রদত্ত
প্রত্নস্থলে  :  প্রত্নস্থল
প্রতিষ্ঠা  :  প্রতিষ্ঠা
প্রতি  :  প্রতি
প্রকৃতি  :  প্রকৃতি
পো  :  পো
পেশ  :  পেশ
পারবে  :  পারব
পানি  :  পানি
পাত্র  :  পাত্
পাঠান  :  পাঠান
পর্বে  :  পর্ব
পরিদর্শন  :  পরিদর্শন
পরিচয়  :  পরিচয়
নেতৃত্বে  :  নেতৃত্ব
নিষিদ্ধ  :  নিষিদ্ধ
নিয়ন্ত্রণ  :  নিয়ন্ত্রণ
নিদর্শনের  :  নিদর্শন
নিদর্শনসমূহের  :  নিদর্শনসমূহ
নারী  :  নারী
নামকরণ  :  নামকরণ
নভেম্বর  :  নভেম্ব
নগর  :  নগর
নকশার  :  নকশা
নকশা  :  নকশা
ধারাবাহিকতায়  :  ধারাবাহিকতায়
দেউলপোতা  :  দেউলপোতা
দুইজন  :  দুইজন
থাকায়  :  থাকায়
তৃতীয়  :  তৃতীয়
তিনজন  :  তিনজন
তাঁরা  :  তাঁর
ড  :  ড
ট্রাইব্যুনালের  :  ট্রাইব্যুনাল
জেনারেল  :  জেনারেল
জুড়ে  :  জুড়
ছাপাঙ্কিত  :  ছাপাঙ্কিত
ছাত্ররা  :  ছাত্রর
ছাত্র  :  ছাত্
ছাড়াও  :  ছাড়াও
চেয়ে  :  চেয়
চন্দ্র  :  চন্দ্
গঠন  :  গঠন
খ্রিস্টীয়  :  খ্রিস্টীয়
খ্রি  :  খ্রি
ক্রুশাকৃতি  :  ক্রুশাকৃতি
ক্রিয়াপদের  :  ক্রিয়াপ
কোথাও  :  কোথাও
কোট  :  কোট
কেন্দ্র  :  কেন্দ্
কৃষি  :  কৃষি
কালো  :  কাল
কাদার  :  কাদা
কাঠ  :  কাঠ
করত  :  করত
কতিপয়  :  কতিপয়
এলাকার  :  এলাকা
এদেশের  :  এদেশ
এছাড়াও  :  এছাড়াও
এগুলিতে  :  এগুলি
একমাত্র  :  একমাত্
এইচ  :  এইচ
উৎখননের  :  উৎখনন
উল্লিখিত  :  উল্লিখিত
উপমহাদেশের  :  উপমহাদেশ
উপদেষ্টা  :  উপদেষ্টা
উদ্দেশ্যে  :  উদ্দেশ্য
উঠেছিল  :  উঠেছিল
উচ্চ  :  উচ্চ
ইসলামী  :  ইসলামী
ইন্ডিয়া  :  ইন্ডিয়া
আসে  :  আসে
আসাম  :  আসাম
আশ্রয়  :  আশ্রয়
আলাদা  :  আলাদা
আট  :  আট
আগস্ট  :  আগস্ট
আইনে  :  আইন
অর্থ  :  অর্থ
অন্যদিকে  :  অন্যদিড
অনুমতি  :  অনুমতি
অংশে  :  অংশ
হোসেন  :  হোসেন
হুগলি  :  হুগলি
হুইলার  :  হুইলা
হাদীস  :  হাদীস
হাতিয়ারের  :  হাতিয়ার
হাজার  :  হাজা
হওয়া  :  হওয়া
স্বাধীন  :  স্বাধীন
স্বর্ণ  :  স্বর্ণ
স্থাপনা  :  স্থাপনা
স্থানের  :  স্থান
স্থলাভিষিক্ত  :  স্থলাভিষিক্ত
স্তরে  :  স্তর
সেগুলোর  :  সেগুল
সেক্ষেত্রে  :  সেক্ষেত্র
সেক্রেটারি  :  সেক্রেটারি
সুফি  :  সুফি
সুপারিন্টেডেন্টের  :  সুপারিন্টেডেন্ট
সু  :  সু
সীতাকোট  :  সীতাকোট
সিলেটের  :  সিলেট
সালিশকারীরা  :  সালিশকারীর
সালিশকারীর  :  সালিশকারী
সার্ভেকে  :  সার্ভেড
সার্বিক  :  সার্বিক
সাময়িকভাবে  :  সাময়িকভাব
সামগ্রী  :  সামগ্রী
সামগ্রিক  :  সামগ্রিক
সম্ভাবনা  :  সম্ভাবনা
সম্ভব  :  সম্ভব
সম্পৃক্ত  :  সম্পৃক্ত
সমসাময়িক  :  সমসাময়িক
সংস্কারের  :  সংস্কার
সংগ্রহের  :  সংগ্রহ
সংগৃহীত  :  সংগৃহীত
শ্রেণি  :  শ্রেণি
শৈল্পিক  :  শৈল্পিক
শুরুতে  :  শুরু
শিল্প  :  শিল্প
শিলালিপি  :  শিলালিপি
শিক্ষাপ্রতিষ্ঠান  :  শিক্ষাপ্রতিষ্ঠান
শাসনের  :  শাসন
শাসন  :  শাসন
লেখা  :  লেখা
লিমিটেড  :  লিমিটেড
লাইসেন্স  :  লাইসেন্স
লক্ষ্য  :  লক্ষ্য
রীতি  :  রীতি
রাজার  :  রাজা
রাজশাহী  :  রাজশাহী
রাজপুতনা  :  রাজপুতনা
রাজধানী  :  রাজধানী
রহিত  :  রহিত
রপ্তানির  :  রপ্তা
রত্ন  :  রত্ন
যাহোক  :  যাহোক
যাতে  :  যাত
যথা  :  যথা
যখন  :  যখন
মেদিনীপুর  :  মেদিনীপু
মেঘনা  :  মেঘনা
মৃৎপাত্র  :  মৃৎপাত্
মূল্য  :  মূল্য
মুসলমান  :  মুসলমান
মুড়ার  :  মুড়া
মুক্তিযোদ্ধাদের  :  মুক্তিযোদ্ধা
মুক্তিযোদ্ধা  :  মুক্তিযোদ্ধা
মালিকানা  :  মালিকানা
মাত্র  :  মাত্
মাঝারি  :  মাঝারি
মা  :  মা
মহাস্থানগড়ের  :  মহাস্থানগড়
মহাস্থানগড়  :  মহাস্থানগড়
মহাপরিচালকের  :  মহাপরিচালক
মহাপরিচালক  :  মহাপরিচালক
মন্দিরের  :  মন্দির
মত  :  মত
মওলানা  :  মওলানা
ভেতর  :  ভেত
ভূমিতে  :  ভূমি
ভূমি  :  ভূমি
ভিত্তি  :  ভিত্তি
ভাবা  :  ভাবা
ভবিষ্যৎ  :  ভবিষ্যৎ
ব্রহ্মপুত্র  :  ব্রহ্মপুত্
ব্যাখ্যা  :  ব্যাখ্যা
ব্যাংকিং  :  ব্যাংকিং
ব্যবস্থাপনা  :  ব্যবস্থাপনা
বৈশিষ্ট্যপূর্ণ  :  বৈশিষ্ট্যপূর্ণ
বৃহত্তম  :  বৃহত্তম
বৃদ্ধি  :  বৃদ্ধি
বিস্ময়কর  :  বিস্ময়ক
বিষয়ের  :  বিষয়
বিষয়ক  :  বিষয়ক
বিশ্বের  :  বিশ্ব
বিশ্ববিদ্যালয়ে  :  বিশ্ববিদ্যালয়
বিশেষত  :  বিশেষত
বিশেষজ্ঞ  :  বিশেষজ্ঞ
বিশৃঙ্খলা  :  বিশৃঙ্খলা
বিরুদ্ধে  :  বিরুদ্ধ
বিভক্ত  :  বিভক্ত
বিবেচিত  :  বিবেচিত
বিবেচনা  :  বিবেচনা
বিবরণ  :  বিবরণ
বিধান  :  বিধান
বিদ্যমান  :  বিদ্যমান
বিচারে  :  বিচার
বাহাদুর  :  বাহাদু
বারো  :  বার
বাঙ্গাল  :  বাঙ্গাল
বস্ত্ত  :  বস্ত্ত
বর্ণনা  :  বর্ণনা
বগুড়ার  :  বগুড়া
প্রাগৈতিহাসিক  :  প্রাগৈতিহাসিক
প্রাকৃতিক  :  প্রাকৃতিক
প্রশাসন  :  প্রশাসন
প্রয়োজনে  :  প্রয়োজন
প্রমাণিত  :  প্রমাণিত
প্রভাব  :  প্রভাব
প্রবেশ  :  প্রবেশ
প্রবর্তন  :  প্রবর্তন
প্রত্যেক  :  প্রত্যেক
প্রত্নবস্ত্তর  :  প্রত্নবস্ত্ত
প্রচুর  :  প্রচু
প্রচলিত  :  প্রচলিত
প্রকাশনা  :  প্রকাশনা
প্রকার  :  প্রকা
পূর্ববর্তী  :  পূর্ববর্তী
পুরানো  :  পুরান
পুংলিঙ্গ  :  পুংলিঙ্গ
পাথর  :  পাথ
পাঠ্য  :  পাঠ্য
পাকবাহিনীর  :  পাকবাহিনী
পর্বের  :  পর্ব
পরিবার  :  পরিবা
পরিণত  :  পরিণত
পরিচালনার  :  পরিচালনা
পরবর্তীকালে  :  পরবর্তীকাল
পরগনার  :  পরগনা
পরগনা  :  পরগনা
পদ্ধতি  :  পদ্ধতি
পক্ষের  :  পক্ষ
পক্ষগুলোর  :  পক্ষ
পক্ষগুলির  :  পক্ষগুলি
পক্ষ  :  পক্ষ
ন্যস্ত  :  ন্যস্ত
নোয়াখালী  :  নোয়াখালী
নেয়  :  নেয়
নিশ্চিত  :  নিশ্চিত
নির্মাণকাল  :  নির্মাণকাল
নির্দিষ্ট  :  নির্দিষ্ট
নিয়োগের  :  নিয়োগ
নিদর্শনসমূহ  :  নিদর্শনসমূহ
নিচের  :  নিচ
নিউ  :  নিউ
নমুনা  :  নমুনা
নদীয়া  :  নদীয়া
ধ্বংস  :  ধ্বংস
ধারার  :  ধারা
ধারাবাহিক  :  ধারাবাহিক
দেয়া  :  দেয়া
দেওয়ানি  :  দেওয়া
দেউল  :  দেউল
দীর্ঘ  :  দীর্ঘ
দীক্ষিত  :  দীক্ষিত
দিনের  :  দিন
দশ  :  দশ
থানা  :  থানা
তৎকালীন  :  তৎকালীন
তিলদা  :  তিলদা
তাম্রলিপি  :  তাম্রলিপি
তাফসির  :  তাফসি
ডিগ্রি  :  ডিগ্রি
ডি  :  ডি
টিকে  :  টিক
টাকা  :  টাকা
জাতীয়  :  জাতীয়
জরিমানা  :  জরিমানা
জরিপকারক  :  জরিপকারক
জমিদার  :  জমিদা
জমা  :  জমা
ছবি  :  ছবি
চেয়ারম্যান  :  চেয়ারম্যান
চুক্তির  :  চুক্তি
চীনামাটির  :  চীনামা
চিত্র  :  চিত্
চারপাশে  :  চারপাশ
চারটি  :  চার
চর্চা  :  চর্চা
চমৎকার  :  চমৎকা
চন্দ্রকেতুগড়ের  :  চন্দ্রকেতুগড়
ঘটে  :  ঘটে
গ্রিক  :  গ্রিক
গ্রন্থে  :  গ্রন্থ
গুটিকা  :  গুটিকা
গভীর  :  গভী
গণ্য  :  গণ্য
খোদাই  :  খোদাই
খেলনা  :  খেলনা
খুঁজে  :  খুঁজ
ক্ষেত্রেই  :  ক্ষেত্রেই
ক্ষুদ্রাকৃতির  :  ক্ষুদ্রাকৃতি
ক্ষতি  :  ক্ষতি
কৌশল  :  কৌশল
কোম্পানি  :  কোম্পা
কেবল  :  কেবল
কেন্দ্রীভূত  :  কেন্দ্রীভূত
কেউ  :  কেউ
কুষাণ  :  কুষাণ
কুমিল্লার  :  কুমিল্লা
কিছুটা  :  কিছুটা
কালাম  :  কালাম
কালক্রমে  :  কালক্রম
কানিংহামের  :  কানিংহাম
কানিংহামকে  :  কানিংহামড
কাজী  :  কাজী
কর্মকর্তা  :  কর্মকর্তা
কয়েকজন  :  কয়েকজন
কমপক্ষে  :  কমপক্ষ
ওঠে  :  ওঠে
ঐতিহ্য  :  ঐতিহ্য
এ্যানসিয়েন্ট  :  এ্যানসিয়েন্ট
এ্যাক্ট  :  এ্যাক্ট
এসেছে  :  এসেছ
এসকল  :  এসকল
এশিয়াটিক  :  এশিয়াটিক
এরূপ  :  এরূপ
এম  :  এম
এবি  :  এবি
এফ  :  এফ
এদেশে  :  এদেশ
এগুলো  :  এগুল
এক্ষেত্রে  :  এক্ষেত্র
একমত  :  একমত
উৎখননে  :  উৎখনন
উপবিষ্ট  :  উপবিষ্ট
উপধারা  :  উপধার
উপজেলায়  :  উপজেলায়
উপকূলীয়  :  উপকূলীয়
উনিশ  :  উনিশ
উদ্ভূত  :  উদ্ভূত
উদ্ভব  :  উদ্ভব
ইসলামিক  :  ইসলামিক
ইমারতের  :  ইমারত
ইতোমধ্যে  :  ইতোমধ্য
ইতিহাস  :  ইতিহাস
আসত  :  আসত
আবু  :  আবু
আববাসীয়  :  আববাসীয়
আবদুল  :  আবদুল
আনুমানিক  :  আনুমানিক
আনন্দ  :  আনন্দ
আধুনিক  :  আধুনিক
আদালত  :  আদালত
আক্রমণ  :  আক্রমণ
অসংখ্য  :  অসংখ্য
অবয়ব  :  অবয়ব
অবদান  :  অবদান
অপরটি  :  অপর
অনুরূপ  :  অনুরূপ
অধ্যাদেশ  :  অধ্যাদেশ
অদ্যাবধি  :  অদ্যাবধি
অট্টালিকার  :  অট্টালিকা
অঞ্চলকে  :  অঞ্চলড
অঞ্চলই  :  অঞ্চলই
হুলট্জেককে  :  হুলট্জেকড
হিক্মত  :  হিক্মত
হাসান  :  হাসান
হায়দ্রাবাদ  :  হায়দ্রাবাদ
হাদীসের  :  হাদীস
হাত  :  হাত
হাটহাজারী  :  হাটহাজারী
হাটবাজার  :  হাটবাজা
হাইকোর্ট  :  হাইকোর্ট
হাঁস  :  হাঁস
হাঁড়ের  :  হাঁড়
হলেন  :  হলেন
হলুদ  :  হলুদ
হরিকালদেবের  :  হরিকালদেব
হত্যা  :  হত্যা
স্যান্ডোয়ে  :  স্যান্ডোয়
স্মৃতিসৌধের  :  স্মৃতিসৌধ
স্মৃতিসৌধসমূহ  :  স্মৃতিসৌধসমূহ
স্মিথ  :  স্মিথ
স্বাস্থ্যকেন্দ্র  :  স্বাস্থ্যকেন্দ্
স্বর্ণমুদ্রাটি  :  স্বর্ণমুদ্রা
স্বর্ণমুদ্রা  :  স্বর্ণমুদ্র
স্বতন্ত্র  :  স্বতন্ত্
স্বচ্ছ  :  স্বচ্ছ
স্নাতক  :  স্নাতক
স্থায়ী  :  স্থায়ী
স্থাবর  :  স্থাব
স্থাপনের  :  স্থাপন
স্থাপনার  :  স্থাপনা
স্থাপত্যের  :  স্থাপত্য
স্থাপত্যিক  :  স্থাপত্যিক
স্থাপত্যবিদ্যার  :  স্থাপত্যবিদ্যা
স্থাপত্যবিদ্যা  :  স্থাপত্যবিদ্যা
স্থানান্তরিত  :  স্থানান্তরিত
স্ত্রীলিঙ্গ  :  স্ত্রীলিঙ্গ
স্তূপ  :  স্তূপ
স্তরীভূত  :  স্তরীভূত
স্টেট  :  স্টেট
স্টক  :  স্টক
স্কিমটি  :  স্কিম
সৌন্দর্য  :  সৌন্দর্য
সোসাইটির  :  সোসাই
সেতু  :  সেতু
সেট  :  সেট
সূর্য  :  সূর্য
সূচনা  :  সূচনা
সূচক  :  সূচক
সুসংবদ্ধ  :  সুসংবদ্ধ
সুষ্ঠুভাবে  :  সুষ্ঠুভাব
সুপারিশমালার  :  সুপারিশমালা
সুপারিশমালা  :  সুপারিশমালা
সুপারিনটেন্ডেন্ট  :  সুপারিনটেন্ডেন্ট
সুনির্দিষ্ট  :  সুনির্দিষ্ট
সীমিত  :  সীমিত
সীমান্ত  :  সীমান্ত
সীতাকুন্ডে  :  সীতাকুন্ড
সিল  :  সিল
সিরিজের  :  সিরিজ
সাহায্য  :  সাহায্য
সালিশের  :  সালিশ
সালিশির  :  সালিশি
সালিশ  :  সালিশ
সাম্রাজ্যের  :  সাম্রাজ্য
সামুদ্রিক  :  সামুদ্রিক
সামান্য  :  সামান্য
সামাজিক  :  সামাজিক
সামনের  :  সামন
সামনে  :  সামন
সাভার  :  সাভা
সহায়তায়  :  সহায়তায়
সহায়তা  :  সহায়তা
সর্বশেষ  :  সর্বশেষ
সম্মুখীন  :  সম্মুখীন
সম্মুখ  :  সম্মুখ
সম্বন্ধে  :  সম্বন্ধ
সম্প্রদায়ের  :  সম্প্রদায়
সম্পূর্ণ  :  সম্পূর্ণ
সম্পন্ন  :  সম্পন্ন
সমাপ্ত  :  সমাপ্ত
সমাধি  :  সমাধি
সমন্দর  :  সমন্দ
সবিশেষ  :  সবিশেষ
সন্ধান  :  সন্ধান
সদৃশ  :  সদৃশ
সদস্য  :  সদস্য
সড়ক  :  সড়ক
সঠিক  :  সঠিক
সক্ষম  :  সক্ষম
সংস্থা  :  সংস্থা
সংস্কার  :  সংস্কা
সংরক্ষণে  :  সংরক্ষণ
সংকেতলিপির  :  সংকেতলিপি
সংকুচিত  :  সংকুচিত
শ্রেণির  :  শ্রেণি
শ্রী  :  শ্রী
শেখানো  :  শেখান
শুঙ্গ  :  শুঙ্গ
শিল্পকলা  :  শিল্পকলা
শিক্ষার্থীদের  :  শিক্ষার্থী
শিক্ষাবিদ  :  শিক্ষাবিদ
শি  :  শি
শাহর  :  শাহ
শাস্ত্র  :  শাস্ত্
শাস্তি  :  শাস্তি
শরৎকুমার  :  শরৎকুমা
শর্ত  :  শর্ত
শরফুদ্দীন  :  শরফুদ্দীন
শত  :  শত
শক্তি  :  শক্তি
লোগো  :  লোগ
লিখিত  :  লিখিত
লালমাই  :  লালমাই
লাভের  :  লাভ
লরেন্স  :  লরেন্স
লম্বা  :  লম্বা
লড়হচন্দ্রের  :  লড়হচন্দ্র
লঙ্ঘন  :  লঙ্ঘন
লক্ষণীয়  :  লক্ষণীয়
রোহিঙ্গ্যাদের  :  রোহিঙ্গ্যা
রোয়েদাদের  :  রোয়েদা
রেটিং  :  রেটিং
রেখেছে  :  রেখেছ
রাষ্ট্রের  :  রাষ্ট্র
রাজ্যের  :  রাজ্য
রাজ্য  :  রাজ্য
রাজাদের  :  রাজা
রাজাকারকে  :  রাজাকারড
রাজবংশের  :  রাজবংশ
রাখার  :  রাখা
রয়্যাল  :  রয়্যাল
রমাচন্দ্রনের  :  রমাচন্দ্রন
রমাচন্দ্রন  :  রমাচন্দ্রন
রঙের  :  রঙে
রক্ষা  :  রক্ষা
রংয়ের  :  রংয়
যোগ্যতা  :  যোগ্যতা
যেসব  :  যেসব
যেমনটি  :  যেমন
যুক্তিবিদ্যা  :  যুক্তিবিদ্যা
যুক্তি  :  যুক্তি
যাত্রা  :  যাত্র
যথাক্রমে  :  যথাক্রম
মৌর্যযুগের  :  মৌর্যযুগ
মেলে  :  মেল
মেধ  :  মেধ
মেজর  :  মেজ
মৃৎপাত্রের  :  মৃৎপাত্র
মূলধনের  :  মূলধন
মূলধন  :  মূলধন
মূর্তিটি  :  মূর্তি
মুরগির  :  মুরগি
মুদ্রাটি  :  মুদ্রা
মিটারেরও  :  মিটারেরও
মাস  :  মাস
মার্শালের  :  মার্শাল
মার্শাল  :  মার্শাল
মার্চে  :  মার্চ
মাযার  :  মাযা
মায়ানমারের  :  মায়ানমার
মায়ানমার  :  মায়ানমা
মানুষের  :  মানুষ
মাদ্রাসাদ্বয়  :  মাদ্রাসাদ্বয়
মাথা  :  মাথা
মহিলা  :  মহিলা
মহাস্থানের  :  মহাস্থান
মহাস্থানে  :  মহাস্থান
মহাবিহার  :  মহাবিহা
মস্তকাবরণ  :  মস্তকাবরণ
মন্দিরসমূহের  :  মন্দিরসমূহ
মন্দিরগুলির  :  মন্দিরগুলি
মন্দিরগুলি  :  মন্দিরগুলি
মন্ত্রণালয়াধীন  :  মন্ত্রণালয়াধীন
মনুমেন্টস  :  মনুমেন্টস
মধ্যম  :  মধ্যম
মতে  :  মতে
মঠটির  :  মঠটি
ভৌগোলিক  :  ভৌগোলিক
ভোজ  :  ভোজ
ভাস্কর্যের  :  ভাস্কর্য
ভাস্কর্যসমূহ  :  ভাস্কর্যসমূহ
ভাষ্য  :  ভাষ্য
ভায়না  :  ভায়না
ভাগে  :  ভাগ
ভাগ  :  ভাগ
ভাই  :  ভাই
ভবন  :  ভবন
ভট্টশালী  :  ভট্টশালী
ব্রাহ্মী  :  ব্রাহ্মী
ব্যুরো  :  ব্যুর
ব্যাপকভাবে  :  ব্যাপকভাব
ব্যয়  :  ব্যয়
ব্যবহারের  :  ব্যবহার
ব্যবহারকারী  :  ব্যবহারকারী
ব্যতিত  :  ব্যতিত
ব্যতিক্রম  :  ব্যতিক্রম
বৌদ্ধমূর্তি  :  বৌদ্ধমূর্তি
বোঝাতে  :  বোঝা
বোঝা  :  বোঝা
বৈষ্ণব  :  বৈষ্ণব
বেলায়  :  বেলায়
বুহারে  :  বুহার
বুহার  :  বুহা
বুলার  :  বুলা
বুন্দেলখন্দ  :  বুন্দেলখন্দ
বুদ্ধ  :  বুদ্ধ
বুকানন  :  বুকানন
বিস্তৃতি  :  বিস্তৃতি
বিষ্ণু  :  বিষ্ণু
বিষয়াদি  :  বিষয়াদি
বিষয়গুলি  :  বিষয়গুলি
বিশ্বাস  :  বিশ্বাস
বিশ্বযুদ্ধের  :  বিশ্বযুদ্ধ
বিশ্ববিদ্যলয়  :  বিশ্ববিদ্যলয়
বিশেষভাবে  :  বিশেষভাব
বিশালাকার  :  বিশালাকা
বিলুপ্তপ্রায়  :  বিলুপ্তপ্রায়
বিভাগে  :  বিভাগ
বিভাগকে  :  বিভাগড
বিভক্তির  :  বিভক্তি
বিবরণী  :  বিবরণী
বিপুলসংখ্যক  :  বিপুলসংখ্যক
বিপুল  :  বিপুল
বিদ্যুৎ  :  বিদ্যুৎ
বিচারপতি  :  বিচারপতি
বিকাশমান  :  বিকাশমান
বাস্তব  :  বাস্তব
বাবা  :  বাবা
বাধ্যতামূলক  :  বাধ্যতামূলক
বাণিজ্যসূত্রে  :  বাণিজ্যসূত্র
বাংলাদেশেই  :  বাংলাদেশেই
বস্ত্তত  :  বস্ত্তত
বসবাস  :  বসবাস
বর্মি  :  বর্মি
বদ্বীপ  :  বদ্বীপ
বড়াল  :  বড়াল
বজায়  :  বজায়
বছরগুলোতে  :  বছর
বঙ্গোপসাগরের  :  বঙ্গোপসাগর
বঙ্গের  :  বঙ্গ
বঙ্গীয়  :  বঙ্গীয়
বংশধরদের  :  বংশধর
ফ্লিটের  :  ফ্লিট
ফ্লিটকে  :  ফ্লিটড
ফ্রান্সিস  :  ফ্রান্সিস
ফিক্হশাস্ত্রের  :  ফিক্হশাস্ত্র
ফিক্হ  :  ফিক্হ
ফারসি  :  ফারসি
ফলাফল  :  ফলাফল
ফলকসমূহের  :  ফলকসমূহ
ফলকসমূহ  :  ফলকসমূহ
ফলকগুলির  :  ফলকগুলি
ফল  :  ফল
ফরাসি  :  ফরাসি
প্রিজারভেশন  :  প্রিজারভেশন
প্রাপ্তির  :  প্রাপ্তি
প্রাচীনতম  :  প্রাচীনতম
প্রাকইতিহাস  :  প্রাকইতিহাস
প্রাক  :  প্রাক
প্রস্তর  :  প্রস্ত
প্রশ্ন  :  প্রশ্ন
প্রশাসনিক  :  প্রশাসনিক
প্রযোজ্য  :  প্রযোজ্য
প্রয়োজনীয়  :  প্রয়োজনীয়
প্রয়োগ  :  প্রয়োগ
প্রমাণাদি  :  প্রমাণাদি
প্রবন্ধ  :  প্রবন্ধ
প্রধানত  :  প্রধানত
প্রদেশের  :  প্রদেশ
প্রথাগত  :  প্রথাগত
প্রত্নস্থলটি  :  প্রত্নস্থল
প্রত্নসম্পদ  :  প্রত্নসম্পদ
প্রত্নকীর্তির  :  প্রত্নকীর্তি
প্রত্নকীর্তিকে  :  প্রত্নকীর্তিড
প্রত্নঅঞ্চলের  :  প্রত্নঅঞ্চল
প্রত্নঅঞ্চলসমূহের  :  প্রত্নঅঞ্চলসমূহ
প্রত্নঅঞ্চল  :  প্রত্নঅঞ্চল
প্রত্ন  :  প্রত্ন
প্রতীক  :  প্রতীক
প্রতিষ্ঠানের  :  প্রতিষ্ঠান
প্রতিষ্ঠাতা  :  প্রতিষ্ঠাতা
প্রতিষ্ঠাকাল  :  প্রতিষ্ঠাকাল
প্রতিনিধিত্ব  :  প্রতিনিধিত্ব
প্রণয়ন  :  প্রণয়ন
প্রচেষ্টার  :  প্রচেষ্টা
প্রচেষ্টা  :  প্রচেষ্টা
প্রচারের  :  প্রচার
প্রচার  :  প্রচা
প্রকৃত  :  প্রকৃত
প্রকাশের  :  প্রকাশ
প্রকারের  :  প্রকার
পেশকৃত  :  পেশকৃত
পেতে  :  পেত
পৃষ্ঠপোষকতায়  :  পৃষ্ঠপোষকতায়
পূর্বাঞ্চলে  :  পূর্বাঞ্চল
পূর্বাঞ্চল  :  পূর্বাঞ্চল
পুরুত্বের  :  পুরুত্ব
পুরাকীর্তি  :  পুরাকীর্তি
পুন্ড্রনগরের  :  পুন্ড্রনগর
পুনঃসংস্কার  :  পুনঃসংস্কা
পিএইচ  :  পিএইচ
পাহাড়ের  :  পাহাড়
পালি  :  পালি
পার্বত্য  :  পার্বত্য
পারস্য  :  পারস্য
পারসিক  :  পারসিক
পান্না  :  পান্না
পাত্রের  :  পাত্র
পাঠ্যসূচি  :  পাঠ্যসূচি
পাঠ  :  পাঠ
পাকিস্তানে  :  পাকিস্তান
পাকসেনা  :  পাকসেনা
পাওয়ার  :  পাওয়া
পাওয়ায়  :  পাওয়ায়
পাঁচটি  :  পাঁচ
পাঁচ  :  পাঁচ
পর্যালোচনা  :  পর্যালোচনা
পর্যায়ের  :  পর্যায়
পর্ব  :  পর্ব
পরীক্ষামূলক  :  পরীক্ষামূলক
পরীক্ষা  :  পরীক্ষা
পরিসরে  :  পরিসর
পরিসংখ্যান  :  পরিসংখ্যান
পরিশোধিত  :  পরিশোধিত
পরিমাণে  :  পরিমাণ
পরিভ্রমণ  :  পরিভ্রমণ
পরিবারের  :  পরিবার
পরিবর্তে  :  পরিবর্
পরবর্তীতে  :  পরবর্তী
পদ্ধতির  :  পদ্ধতি
পদের  :  পদে
পদাঙ্ক  :  পদাঙ্ক
পদক্ষেপ  :  পদক্ষেপ
পদও  :  পদও
পথ  :  পথ
পত্রিকা  :  পত্রিকা
পত্র  :  পত্
পতনের  :  পতন
পণ্যদ্রব্যাদি  :  পণ্যদ্রব্যাদি
পড়ে  :  পড়
পঠিত  :  পঠিত
পঠন  :  পঠন
পক্ষগুলি  :  পক্ষগুলি
ন্যায়  :  ন্যায়
নৌকা  :  নৌকা
নেয়ার  :  নেয়া
নেন  :  নেন
নৃতাত্ত্বিক  :  নৃতাত্ত্বিক
নীতি  :  নীতি
নিষ্পত্তির  :  নিষ্পত্তি
নির্দেশনায়  :  নির্দেশনায়
নির্দেশনা  :  নির্দেশনা
নিয়োগে  :  নিয়োগ
নিম্নরূপ  :  নিম্নরূপ
নিবিড়  :  নিবিড়
নিবাস  :  নিবাস
নিদর্শনাদি  :  নিদর্শনাদি
নিচে  :  নিচ
নিকুঞ্জ  :  নিকুঞ্জ
নামের  :  নাম
নামায  :  নামায
নাটশাল  :  নাটশাল
নলকূপের  :  নলকূপ
নরসিংদী  :  নরসিংদী
নবোপলীয়  :  নবোপলীয়
নদী  :  নদী
নওগাঁ  :  নওগাঁ
ধ্বংসাবশেষসমূহ  :  ধ্বংসাবশেষসমূহ
ধীরে  :  ধীর
ধারায়  :  ধারায়
ধারাবাহিকতা  :  ধারাবাহিকতা
ধারাটি  :  ধারা
ধান  :  ধান
ধাতু  :  ধাতু
ধর্মের  :  ধর্ম
ধর্মাবলম্বী  :  ধর্মাবলম্বী
দ্রুত  :  দ্রুত
দেশই  :  দেশই
দেয়ালের  :  দেয়াল
দেয়  :  দেয়
দেওয়ার  :  দেওয়া
দূরবর্তী  :  দূরবর্তী
দীক্ষিতের  :  দীক্ষিত
দিয়েছিলেন  :  দিয়েছিলেন
দায়িত্বভার  :  দায়িত্বভা
দাবি  :  দাবি
দাঁড়ায়  :  দাঁড়ায়
দশকের  :  দশক
দর্শন  :  দর্শন
দমন  :  দমন
থানার  :  থানা
থাকলেও  :  থাকলেও
তৈরির  :  তৈরি
তেরো  :  তের
তুর্ক  :  তুর্ক
তীক্ষ্ণ  :  তীক্ষ্ণ
তাৎপর্যপূর্ণ  :  তাৎপর্যপূর্ণ
তালিকাভুক্ত  :  তালিকাভুক্ত
তালিকা  :  তালিকা
তারিখ  :  তারিখ
তাম্রশাসন  :  তাম্রশাসন
তামবুকিয়াদের  :  তামবুকিয়া
তহবিল  :  তহবিল
তন  :  তন
তখনও  :  তখনও
ত  :  ত
ঢালাই  :  ঢালাই
ডেপুটি  :  ডেপু
ডিসেম্বর  :  ডিসেম্ব
ট্রোভ  :  ট্রোভ
ট্রাইব্যুনালে  :  ট্রাইব্যুনাল
ট্রাইব্যুনাল  :  ট্রাইব্যুনাল
টুকরা  :  টুকর
টাকার  :  টাকা
জ্ঞান  :  জ্ঞান
জেলা  :  জেলা
জেল  :  জেল
জেমস  :  জেমস
জেনারেলের  :  জেনারেল
জীবনের  :  জীবন
জি  :  জি
জার্নালে  :  জার্নাল
জার্নালও  :  জার্নালও
জানুয়ারি  :  জানুয়ারি
জানার  :  জানা
জাদুঘর  :  জাদুঘ
জলস্তরের  :  জলস্তর
জমি  :  জমি
জনসংখ্যা  :  জনসংখ্যা
জনগোষ্ঠীর  :  জনগোষ্ঠী
জনগণের  :  জনগণ
জটার  :  জটা
ছোট্ট  :  ছোট্ট
চুক্তিতে  :  চুক্তি
চুক্তি  :  চুক্তি
চীনের  :  চীন
চিহ্নিতকরণ  :  চিহ্নিতকরণ
চাকা  :  চাকা
চাকরির  :  চাকরি
চর্চায়  :  চর্চায়
চট্টগ্রামের  :  চট্টগ্রাম
চট্টগ্রামে  :  চট্টগ্রাম
চওড়া  :  চওড়া
ঘর  :  ঘর
ঘটনা  :  ঘটনা
গ্রামের  :  গ্রাম
গ্রাম  :  গ্রাম
গ্রন্থের  :  গ্রন্থ
গোইং  :  গোইং
গুলোর  :  গুল
গুলো  :  গুল
গুরাবা  :  গুরাবা
গুপ্তধন  :  গুপ্তধন
গাড়িতে  :  গাড়ি
গভর্নর  :  গভর্ন
গবেষণামূলক  :  গবেষণামূলক
গবাদিপশু  :  গবাদিপশু
গণপূর্ত  :  গণপূর্ত
গঠনের  :  গঠন
গ  :  গ
খ্রিস্টাব্দের  :  খ্রিস্টাব্
খুবই  :  খুবই
খুব  :  খুব
খামার  :  খামা
খানকাহ  :  খানকাহ
খলিফাদের  :  খলিফা
খলিফা  :  খলিফা
খন্ড  :  খন্ড
খননের  :  খনন
খড়গ  :  খড়গ
খ  :  খ
ক্ষেত্রেও  :  ক্ষেত্রেও
ক্ষমতার  :  ক্ষমতা
ক্রেডিট  :  ক্রেডিট
ক্রুশাকৃতির  :  ক্রুশাকৃতি
ক্রিয়াপদ  :  ক্রিয়াপদ
কোনটি  :  কোন
কেনো  :  কেন
কেন  :  কেন
কিছুকাল  :  কিছুকাল
কিউরেটর  :  কিউরেট
কার্যক্রমের  :  কার্যক্রম
কার্নেলিয়ান  :  কার্নেলিয়ান
কামরূপ  :  কামরূপ
কাঠে  :  কাঠ
কাঠামো  :  কাঠাম
কাঁচের  :  কাঁচ
কলেজ  :  কলেজ
কলকাতায়  :  কলকাতায়
কর্মরত  :  কর্মরত
করতেন  :  করতেন
কমিটির  :  কমি
কবি  :  কবি
কথাও  :  কথাও
ক  :  ক
এ্যানুয়াল  :  এ্যানুয়াল
এশিয়ার  :  এশিয়া
এরপর  :  এরপ
এভাবেই  :  এভাবেই
এভাবে  :  এভাব
এপ্রিল  :  এপ্রিল
এক্সচেঞ্জ  :  এক্সচেঞ্জ
একেবারে  :  একেবার
একীভূত  :  একীভূত
একাধিক  :  একাধিক
একশ  :  একশ
একটা  :  একটা
এককটির  :  একক
ঋণ  :  ঋণ
উৎস  :  উৎস
উৎপাদিত  :  উৎপাদিত
উৎপন্ন  :  উৎপন্ন
উৎপত্তি  :  উৎপত্তি
উৎখননকৃত  :  উৎখননকৃত
উল  :  উল
উপরিভাগে  :  উপরিভাগ
উপজেলার  :  উপজেলা
উপজেলা  :  উপজেলা
উপকূল  :  উপকূল
উদ্ভবের  :  উদ্ভব
উত্তীর্ণ  :  উত্তীর্ণ
উঠে  :  উঠে
উচ্চমানের  :  উচ্চমান
উক্ত  :  উক্ত
ইম্পেরিয়াল  :  ইম্পেরিয়াল
ইমাম  :  ইমাম
ইন্দো  :  ইন্দ
ইন্ডিয়ান  :  ইন্ডিয়ান
ইন্টারমিডিয়েট  :  ইন্টারমিডিয়েট
ইত্যাদির  :  ইত্যাদি
ইটের  :  ইটে
ইট  :  ইট
ইউনিয়ন  :  ইউনিয়ন
ইউনিট  :  ইউনিট
ইংরেজ  :  ইংরেজ
আহমদ  :  আহমদ
আসা  :  আসা
আসছে  :  আসছ
আশ্চর্য  :  আশ্চর্য
আশরাফ  :  আশরাফ
আলোচিত  :  আলোচিত
আলোচনায়  :  আলোচনায়
আলোচনা  :  আলোচনা
আলীয়া  :  আলীয়া
আর্কিওলোজিক্যাল  :  আর্কিওলোজিক্যাল
আরেকটি  :  আরেক
আরাকানিরাই  :  আরাকানিরাই
আরাকানিদের  :  আরাকা
আরবির  :  আরবি
আরতির  :  আরতি
আমেরিকান  :  আমেরিকান
আবিষ্কারসমূহ  :  আবিষ্কারসমূহ
আপীল  :  আপীল
আনু  :  আনু
আদালতের  :  আদালত
আদমশুমারি  :  আদমশুমারি
আটঘরা  :  আটঘর
আঞ্চলিক  :  আঞ্চলিক
আজমির  :  আজমি
আজও  :  আজও
আগমন  :  আগমন
আকিক  :  আকিক
আকারে  :  আকার
আওতায়  :  আওতায়
আওতাধীন  :  আওতাধীন
আইনটিতে  :  আইন
আংশিক  :  আংশিক
অস্বীকৃতি  :  অস্বীকৃতি
অলঙ্কৃত  :  অলঙ্কৃত
অলংকারশাস্ত্র  :  অলংকারশাস্ত্
অর্থোদ্ধার  :  অর্থোদ্ধা
অর্জন  :  অর্জন
অর  :  অর
অভিলেখন  :  অভিলেখন
অভিযোগ  :  অভিযোগ
অবস্থান  :  অবস্থান
অবস্থা  :  অবস্থা
অবসর  :  অবস
অবশ্যই  :  অবশ্যই
অবশিষ্ট  :  অবশিষ্ট
অবলুপ্তি  :  অবলুপ্তি
অপর  :  অপর
অন্তর্গত  :  অন্তর্গত
অনুসৃত  :  অনুসৃত
অনুসারে  :  অনুসার
অনুসন্ধানের  :  অনুসন্ধান
অনুমোদিত  :  অনুমোদিত
অনুপ্রবেশ  :  অনুপ্রবেশ
অনুধাবন  :  অনুধাবন
অনন্য  :  অনন্য
অধ্যয়ন  :  অধ্যয়ন
অধিষ্ঠিত  :  অধিষ্ঠিত
অধিদপ্তরের  :  অধিদপ্তর
অধিকার  :  অধিকা
অতীতে  :  অতী
অতীত  :  অতীত
অতিক্রম  :  অতিক্রম
অঞ্চলসমূহের  :  অঞ্চলসমূহ
অজানা  :  অজানা
অগ্রগণ্য  :  অগ্রগণ্য
অংশের  :  অংশ
হ্রাস  :  হ্রাস
হোসেনের  :  হোসেন
হেস্টিংস  :  হেস্টিংস
হেনরি  :  হেনরি
হুলটজেককে  :  হুলটজেকড
হুমকির  :  হুমকি
হুজ্জাত  :  হুজ্জাত
হিসাব  :  হিসাব
হিন্দুদের  :  হিন্দু
হিন্দি  :  হিন্দি
হিদায়তুন  :  হিদায়তুন
হাসপাতাল  :  হাসপাতাল
হালাল  :  হালাল
হাল  :  হাল
হার্ন্ডিজ  :  হার্ন্ডিজ
হারুন  :  হারুন
হারিরি  :  হারিরি
হারিয়ে  :  হারিয়
হারাম  :  হারাম
হায়দ্রাবাদসহ  :  হায়দ্রাবাদসহ
হাম্দ  :  হাম্দ
হামযা  :  হামযা
হাবিবুল্লাহ  :  হাবিবুল্লাহ
হানিফ  :  হানিফ
হাদীসে  :  হাদীস
হাদীসই  :  হাদীসই
হাদী  :  হাদী
হাদিপুর  :  হাদিপু
হাতির  :  হাতি
হাতিয়ারসমূহের  :  হাতিয়ারসমূহ
হাতি  :  হাতি
হাতল  :  হাতল
হাওদুল  :  হাওদুল
হাওড়া  :  হাওড়া
হাইজাদিতে  :  হাইজাদি
হাঁড়  :  হাঁড়
হস্তনির্মিত  :  হস্তনির্মিত
হস্তক্ষেপ  :  হস্তক্ষেপ
হরোয়া  :  হরোয়া
হরিনারায়ণপুরের  :  হরিনারায়ণপুর
হরিকেল  :  হরিকেল
হয়েছিলেন  :  হয়েছিলেন
হয়াত  :  হয়াত
হযরত  :  হযরত
হদিস  :  হদিস
হঠাৎ  :  হঠাৎ
হজ্জ  :  হজ্জ
হক  :  হক
স্মৃতিসৌধসমূহের  :  স্মৃতিসৌধসমূহ
স্মৃতিসৌধসমূহকে  :  স্মৃতিসৌধসমূহড
স্মৃতিসৌধগুলোকে  :  স্মৃতিসৌধগুলোড
স্মারকের  :  স্মারক
স্বাস্থ্যকর  :  স্বাস্থ্যক
স্বাস্থ্য  :  স্বাস্থ্য
স্বার্থসংশ্লিষ্ট  :  স্বার্থসংশ্লিষ্ট
স্বামী  :  স্বামী
স্বল্পমেয়াদি  :  স্বল্পমেয়াদি
স্বর্ণের  :  স্বর্ণ
স্বর্ণশিল্প  :  স্বর্ণশিল্প
স্বর্ণযুগ  :  স্বর্ণযুগ
স্বরবর্ণ  :  স্বরবর্ণ
স্বতন্ত্রভাগে  :  স্বতন্ত্রভাগ
স্ফটিক  :  স্ফটিক
স্প্যানিশ  :  স্প্যানিশ
স্পষ্টত  :  স্পষ্টত
স্থায়ীভাবে  :  স্থায়ীভাব
স্থায়ীত্বের  :  স্থায়ীত্ব
স্থাপনাসমূহের  :  স্থাপনাসমূহ
স্থাপনকারীরা  :  স্থাপনকারীর
স্থাপত্যটির  :  স্থাপত্য
স্থাপত্যকলার  :  স্থাপত্যকলা
স্থাপত্যকর্মের  :  স্থাপত্যকর্ম
স্থাপত্যকর্মটির  :  স্থাপত্যকর্ম
স্থাপত্যও  :  স্থাপত্যও
স্থানীয়ভাবে  :  স্থানীয়ভাব
স্থানগুলি  :  স্থানগুলি
স্থলগুলির  :  স্থলগুলি
স্থপতি  :  স্থপতি
স্তোত্রাদি  :  স্তোত্রাদি
স্তূপের  :  স্তূপ
স্তূপসমূহের  :  স্তূপসমূহ
স্তূপগুলি  :  স্তূপগুলি
স্তরের  :  স্তর
স্তরবিন্যাস  :  স্তরবিন্যাস
স্তরকে  :  স্তরড
স্তম্ভ  :  স্তম্ভ
স্টেটের  :  স্টেট
স্টাফোর্ডের  :  স্টাফোর্ড
স্টাডিজ  :  স্টাডিজ
স্কুলের  :  স্কুল
স্কিমের  :  স্কিম
স্কিম  :  স্কিম
সৌন্দর্যে  :  সৌন্দর্য
সোহরাওয়ার্দী  :  সোহরাওয়ার্দী
সোরাহীর  :  সোরাহী
সোরাহী  :  সোরাহী
সোয়া  :  সোয়া
সোমপুরে  :  সোমপুর
সোনারগাঁও  :  সোনারগাঁও
সোনার  :  সোনা
সৈয়দ  :  সৈয়দ
সেসব  :  সেসব
সেসকল  :  সেসকল
সেমিটিক  :  সেমিটিক
সেভাবেই  :  সেভাবেই
সেবার  :  সেবা
সেপ্টেম্বর  :  সেপ্টেম্ব
সেনাবাহিনীতে  :  সেনাবাহিনী
সেগুলো  :  সেগুল
সেগুলির  :  সেগুলি
সেখানকার  :  সেখানকা
সেক্টরের  :  সেক্টর
সৃষ্ট  :  সৃষ্ট
সূত্রপাত  :  সূত্রপাত
সূত্র  :  সূত্
সূতপ  :  সূতপ
সূচিত  :  সূচিত
সুস্পষ্টভাবে  :  সুস্পষ্টভাব
সুস্পষ্ট  :  সুস্পষ্ট
সুসজ্জিত  :  সুসজ্জিত
সুশৃঙ্খল  :  সুশৃঙ্খল
সুলায়মান  :  সুলায়মান
সুরাহা  :  সুরাহা
সুরতন  :  সুরতন
সুরক্ষিত  :  সুরক্ষিত
সুফিদের  :  সুফি
সুফিতত্ত্ব  :  সুফিতত্ত্ব
সুপ্রিম  :  সুপ্রিম
সুপ্রসিদ্ধ  :  সুপ্রসিদ্ধ
সুপ্রতিষ্ঠিত  :  সুপ্রতিষ্ঠিত
সুপারিশের  :  সুপারিশ
সুপারিন্টিডেন্ট  :  সুপারিন্টিডেন্ট
সুপরিকল্পিতভাবে  :  সুপরিকল্পিতভাব
সুন্নত  :  সুন্নত
সুন্দর  :  সুন্দ
সুদৃশ্য  :  সুদৃশ্য
সুদূর  :  সুদূ
সুদীর্ঘ  :  সুদীর্ঘ
সুতরাং  :  সুতরাং
সুজার  :  সুজা
সুজা  :  সুজা
সুখ্যাতি  :  সুখ্যাতি
সুওয়াম  :  সুওয়াম
সীমাবদ্ধ  :  সীমাবদ্ধ
সীতাকোটের  :  সীতাকোট
সিহালভী  :  সিহালভী
সিলেট  :  সিলেট
সিলমোহরের  :  সিলমোহর
সিলমোহরে  :  সিলমোহর
সিন্ধুসভ্যতা  :  সিন্ধুসভ্যতা
সিন্ধুর  :  সিন্ধু
সিন্ধুতে  :  সিন্ধু
সিন্ডিকেটেড  :  সিন্ডিকেটেড
সিটটয়ে  :  সিটটয়
সিঙ্গার  :  সিঙ্গা
সিক্রি  :  সিক্রি
সিকান্দারাবাদের  :  সিকান্দারাবা
সিংহাসনে  :  সিংহাসন
সিংহাসন  :  সিংহাসন
সাহিত্যকে  :  সাহিত্যড
সাহায্যেই  :  সাহায্যেই
সাহসী  :  সাহসী
সাসানিদ  :  সাসানিদ
সালেউৎখনন  :  সালেউৎখনন
সালিশীর  :  সালিশী
সালিশী  :  সালিশী
সালিশকারীদের  :  সালিশকারী
সালিশকারীকে  :  সালিশকারীড
সার্ভেয়রকে  :  সার্ভেয়রড
সার্ভেয়র  :  সার্ভেয়
সার্কেল  :  সার্কেল
সারিতে  :  সারি
সাম্প্রতিককালের  :  সাম্প্রতিককাল
সামি  :  সামি
সামারকান্দীর  :  সামারকান্দী
সামরিক  :  সামরিক
সাময়িক  :  সাময়িক
সামগ্রীর  :  সামগ্রী
সাফল্য  :  সাফল্য
সান  :  সান
সাধকরা  :  সাধকর
সাধকদের  :  সাধক
সাধকগণ  :  সাধকগণ
সাধক  :  সাধক
সাদাসর্দি  :  সাদাসর্দি
সাওঘাটে  :  সাওঘাট
সাইটিক  :  সাইটিক
সাংস্কৃতিকভাবে  :  সাংস্কৃতিকভাব
সাঁটা  :  সাঁটা
সহায়তাদানের  :  সহায়তাদান
সহায়ক  :  সহায়ক
সহস্রাধিক  :  সহস্রাধিক
সহযোগী  :  সহযোগী
সহযোগিতায়  :  সহযোগিতায়
সহনীয়  :  সহনীয়
সহজ  :  সহজ
সহকারে  :  সহকার
সহকারীসহ  :  সহকারীসহ
সহকারীদের  :  সহকারী
সহ  :  সহ
সষ্টি  :  সষ্
সর্বোতভদ্র  :  সর্বোতভদ্
সর্বমোট  :  সর্বমোট
সর্বপ্রথম  :  সর্বপ্রথম
সর্বত্র  :  সর্বত্
সর্বক্ষেত্রে  :  সর্বক্ষেত্র
সরিষাদহ  :  সরিষাদহ
সরিষা  :  সরিষা
সরবরাহে  :  সরবরাহ
সরকারী  :  সরকারী
সরকারগুলোকে  :  সরকারগুলোড
সম্রাটের  :  সম্রাট
সম্মিলিতভাবে  :  সম্মিলিতভাব
সম্মানিত  :  সম্মানিত
সম্মতিক্রমে  :  সম্মতিক্রম
সম্মত  :  সম্মত
সম্ভ্রান্ত  :  সম্ভ্রান্ত
সম্ভাব্য  :  সম্ভাব্য
সম্বদ্ধে  :  সম্বদ্ধ
সম্প্রদায়  :  সম্প্রদায়
সম্পূর্ণরূপে  :  সম্পূর্ণরূপ
সম্পূর্ণভাবে  :  সম্পূর্ণভাব
সম্পূর্ণতা  :  সম্পূর্ণতা
সম্পদ  :  সম্পদ
সম্পত্তি  :  সম্পত্তি
সমৃদ্ধিশালী  :  সমৃদ্ধিশালী
সমৃদ্ধির  :  সমৃদ্ধি
সমৃদ্ধি  :  সমৃদ্ধি
সমৃদ্ধ  :  সমৃদ্ধ
সমূহকে  :  সমূহড
সমূহও  :  সমূহও
সমুদ্রে  :  সমুদ্র
সমুদ্রগামী  :  সমুদ্রগামী
সমীক্ষা  :  সমীক্ষা
সমাহিত  :  সমাহিত
সমাহার  :  সমাহা
সমার্থক  :  সমার্থক
সমান  :  সমান
সমাধিস্ত  :  সমাধিস্ত
সমাজের  :  সমাজ
সমস্যার  :  সমস্যা
সমস্যা  :  সমস্যা
সমসংখ্যক  :  সমসংখ্যক
সমর্থন  :  সমর্থন
সমর্থকদের  :  সমর্থক
সমন্বিত  :  সমন্বিত
সমন্বয়ে  :  সমন্বয়
সমন্বয়  :  সমন্বয়
সমতুল্য  :  সমতুল্য
সমতল  :  সমতল
সমতট  :  সমতট
সমজাতীয়  :  সমজাতীয়
সবগুলিতেই  :  সবগুলিতেই
সপ্তম  :  সপ্তম
সপরিবারে  :  সপরিবার
সন্নিকটে  :  সন্নিকট
সন্ধ্যায়  :  সন্ধ্যায়
সন্দ্বীপে  :  সন্দ্বীপ
সন্দ্বীপ  :  সন্দ্বীপ
সনাতন  :  সনাতন
সদ্রুদ্দীনের  :  সদ্রুদ্দীন
সদ্য  :  সদ্য
সদস্যের  :  সদস্য
সঠিকভাবে  :  সঠিকভাব
সঞ্চালন  :  সঞ্চালন
সঞ্চার  :  সঞ্চা
সঞ্চয়  :  সঞ্চয়
সজ্জিত  :  সজ্জিত
সচিত্র  :  সচিত্
সঙ্গেই  :  সঙ্গেই
সঙ্গীতবিদ্যা  :  সঙ্গীতবিদ্যা
সঙ্গমস্থলের  :  সঙ্গমস্থল
সঙ্গত  :  সঙ্গত
সংস্কৃতি  :  সংস্কৃতি
সংস্কারই  :  সংস্কারই
সংসদের  :  সংস
সংসদ  :  সংসদ
সংশোধনের  :  সংশোধন
সংশোধনীসমূহ  :  সংশোধনীসমূহ
সংলগ্ন  :  সংলগ্ন
সংরক্ষণেরই  :  সংরক্ষণেরই
সংরক্ষণেও  :  সংরক্ষণেও
সংযোজন  :  সংযোজন
সংযোগকে  :  সংযোগড
সংযোগ  :  সংযোগ
সংমিশ্রণ  :  সংমিশ্রণ
সংঘটিত  :  সংঘটিত
সংঘটন  :  সংঘটন
সংগঠনের  :  সংগঠন
সংখ্যার  :  সংখ্যা
সংখ্যায়  :  সংখ্যায়
সংখ্যাও  :  সংখ্যাও
সংক্ষিপ্ত  :  সংক্ষিপ্ত
সংকলন  :  সংকলন
ষোল  :  ষোল
ষাটের  :  ষাট
শ্রেণিসমূহে  :  শ্রেণিসমূহ
শ্রেণিতে  :  শ্রেণি
শ্রেণিও  :  শ্রেণিও
শ্রমে  :  শ্রম
শ্রমিকের  :  শ্রমিক
শ্রমিকদের  :  শ্রমিক
শোনা  :  শোনা
শৈলীতে  :  শৈলী
শেষভাগের  :  শেষভাগ
শেখার  :  শেখা
শুদ্ধ  :  শুদ্ধ
শীতলপাটি  :  শীতলপা
শিশুর  :  শিশু
শিশু  :  শিশু
শিল্পের  :  শিল্প
শিল্পকর্মের  :  শিল্পকর্ম
শিল্পকর্ম  :  শিল্পকর্ম
শিলাস্তর  :  শিলাস্ত
শিলালিপিতে  :  শিলালিপি
শিলা  :  শিলা
শিরোনাম  :  শিরোনাম
শিবমন্দির  :  শিবমন্দি
শিখে  :  শিখ
শিখর  :  শিখ
শিক্ষিত  :  শিক্ষিত
শিক্ষালয়  :  শিক্ষালয়
শিক্ষার্থীদেরকেও  :  শিক্ষার্থীদেরকেও
শিক্ষায়  :  শিক্ষায়
শিক্ষাব্যবস্থা  :  শিক্ষাব্যবস্থা
শিক্ষাবর্ষে  :  শিক্ষাবর্ষ
শিক্ষাদানের  :  শিক্ষাদান
শিক্ষাক্রম  :  শিক্ষাক্রম
শিক্ষাকে  :  শিক্ষাড
শিক্ষাও  :  শিক্ষাও
শিক্ষক  :  শিক্ষক
শাহের  :  শাহ
শাহেথ  :  শাহেথ
শাহবাজপুর  :  শাহবাজপু
শাস্তির  :  শাস্তি
শাসনে  :  শাসন
শাসনকাল  :  শাসনকাল
শাসনকার্য  :  শাসনকার্য
শাসনকর্তা  :  শাসনকর্তা
শালবনবিহারের  :  শালবনবিহার
শারীরিক  :  শারীরিক
শারকি  :  শারকি
শাম্স  :  শাম্স
শামসুল  :  শামসুল
শান্তিপ্রয়াসী  :  শান্তিপ্রয়াসী
শান্তিপূর্ণ  :  শান্তিপূর্ণ
শান্তি  :  শান্তি
শানপুকুর  :  শানপুকু
শাড়ি  :  শাড়ি
শাখায়  :  শাখায়
শাখাতেই  :  শাখাতেই
শাখাটির  :  শাখা
শাকসবজি  :  শাকসবজি
শাঁখ  :  শাঁখ
শহরে  :  শহর
শহরতলি  :  শহরতলি
শস্যকর্তনরত  :  শস্যকর্তনরত
শলাকা  :  শলাকা
শর্মী  :  শর্মী
শর্তানুযায়ী  :  শর্তানুযায়ী
শরীফেরও  :  শরীফেরও
শরীফের  :  শরীফ
শরণার্থী  :  শরণার্থী
শব্দলজাত  :  শব্দলজাত
শব্দদ্বয়  :  শব্দদ্বয়
শব্দটির  :  শব্দ
শফির  :  শফি
শতাব্দীর  :  শতাব্দী
শতাধিক  :  শতাধিক
শঙ্খ  :  শঙ্খ
শক্তিশালী  :  শক্তিশালী
শ  :  শ
লৌহশিল্প  :  লৌহশিল্প
লোকেরা  :  লোক
লোক  :  লোক
লেফটেন্যান্ট  :  লেফটেন্যান্ট
লেউর  :  লেউ
লুকিয়ে  :  লুকিয়
লিপিসমূহে  :  লিপিসমূহ
লিপিরই  :  লিপিরই
লিপিভাষ্য  :  লিপিভাষ্য
লিপিকারক  :  লিপিকারক
লিটন  :  লিটন
লিচু  :  লিচু
লিঙ্গ  :  লিঙ্গ
লিখেছেন  :  লিখেছেন
লিখেছিলেন  :  লিখেছিলেন
লিখনপদ্ধতি  :  লিখনপদ্ধতি
লিখন  :  লিখন
লিখতে  :  লিখ
লিওনার্ড  :  লিওনার্ড
লালবাগ  :  লালবাগ
লাববাইক  :  লাববাইক
লাববাই  :  লাববাই
লাগানো  :  লাগান
লস্কর  :  লস্ক
ললিতপুর  :  ললিতপু
লম্বাকৃতির  :  লম্বাকৃতি
লতার  :  লতা
লড়াইয়ে  :  লড়াইয়
লড়াই  :  লড়াই
লঙ্ঘনে  :  লঙ্ঘন
লক্ষ্ণৌর  :  লক্ষ্ণৌ
লক্ষিন্দরের  :  লক্ষিন্দর
লক্ষণসেনের  :  লক্ষণসেন
লক্ষ  :  লক্ষ
ল  :  ল
র্চ্চার  :  র্চ্চা
রৌপ্যের  :  রৌপ্য
রোহিঙ্গ্যারা  :  রোহিঙ্গ্যার
রোয়োদাদ  :  রোয়োদাদ
রোমান  :  রোমান
রোমাঞ্চকর  :  রোমাঞ্চক
রোপণের  :  রোপণ
রেমিটেন্স  :  রেমিটেন্স
রেজিস্ট্রারে  :  রেজিস্ট্রার
রেজিস্ট্রার  :  রেজিস্ট্রা
রেগুলেশনের  :  রেগুলেশন
রেখেছেন  :  রেখেছেন
রেখেছিল  :  রেখেছিল
রেখেই  :  রেখেই
রেকর্ড  :  রেকর্ড
রূপে  :  রূপ
রূপান্তর  :  রূপান্ত
রূপই  :  রূপই
রূপ  :  রূপ
রুলেট  :  রুলেট
রুলস  :  রুলস
রুমুয  :  রুমুয
রুমী  :  রুমী
রুপির  :  রুপি
রুপি  :  রুপি
রুকনউদ্দীন  :  রুকনউদ্দীন
রীতিতে  :  রীতি
রীতিও  :  রীতিও
রিপোর্টস  :  রিপোর্টস
রিপোর্টগুলির  :  রিপোর্টগুলি
রিপনের  :  রিপন
রিজার্ভ  :  রিজার্ভ
রি  :  রি
রাষ্ট্রভাষা  :  রাষ্ট্রভাষা
রাষ্ট্র  :  রাষ্ট্
রায়ের  :  রায়
রায়দিঘি  :  রায়দিঘি
রামায়ণের  :  রামায়ণ
রামমোহন  :  রামমোহন
রামপালে  :  রামপাল
রামচরিতম্  :  রামচরিতম্
রানীর  :  রানী
রাধানগর  :  রাধানগ
রাঢ়  :  রাঢ়
রাজ্যটিকে  :  রাজ্যটিড
রাজ্যকে  :  রাজ্যড
রাজ্যও  :  রাজ্যও
রাজী  :  রাজী
রাজারা  :  রাজার
রাজাকে  :  রাজাড
রাজসভায়  :  রাজসভায়
রাজশাহীতে  :  রাজশাহী
রাজবংশ  :  রাজবংশ
রাজপুতনাসহ  :  রাজপুতনাসহ
রাজনৈতিকভাবেও  :  রাজনৈতিকভাবেও
রাজত্ব  :  রাজত্ব
রাজক্ষমতা  :  রাজক্ষমতা
রাখাইনপিয়ে  :  রাখাইনপিয়
রাখাইন  :  রাখাইন
রাক্ষস  :  রাক্ষস
রাইস  :  রাইস
রাইফেলসহ  :  রাইফেলসহ
রসকে  :  রসক
রশিদের  :  রশি
রশিদ  :  রশিদ
রয়ে  :  রয়
রমাপ্রসাদ  :  রমাপ্রসাদ
রমরী  :  রমরী
রপ্তানিদ্রব্য  :  রপ্তানিদ্রব্য
রদবদল  :  রদবদল
রণবঙ্কমল্ল  :  রণবঙ্কমল্ল
রজারসের  :  রজারস
রজব  :  রজব
রঙ্গীন  :  রঙ্গীন
রক্ষার্থে  :  রক্ষার্থ
রক্ষার  :  রক্ষা
রক্ষণাবেক্ষণে  :  রক্ষণাবেক্ষণ
রক্তক্ষয়ী  :  রক্তক্ষয়ী
রংপুর  :  রংপু
যোগী  :  যোগী
যোগশাস্ত্রের  :  যোগশাস্ত্র
যোগ  :  যোগ
যেভাবে  :  যেভাব
যেত  :  যেত
যেটির  :  যেটি
যেগুলো  :  যেগুল
যেগুলির  :  যেগুলি
যেগুলি  :  যেগুলি
যুদ্ধে  :  যুদ্ধ
যুদ্ধমন্ত্রী  :  যুদ্ধমন্ত্রী
যুদ্ধ  :  যুদ্ধ
যুগ্ম  :  যুগ্ম
যুগোপযোগী  :  যুগোপযোগী
যুগান্তকারী  :  যুগান্তকারী
যুগল  :  যুগল
যুগ  :  যুগ
যুক্তরাজ্যের  :  যুক্তরাজ্য
যিয়াফত  :  যিয়াফত
যায়নি  :  যায়
যাবতীয়  :  যাবতীয়
যাত্রাবাড়ী  :  যাত্রাবাড়ী
যাতায়াত  :  যাতায়াত
যাচ্ছে  :  যাচ্ছ
যাচাই  :  যাচাই
যাকাত  :  যাকাত
যাক  :  যাক
যাওয়ার  :  যাওয়া
যাওয়ায়  :  যাওয়ায়
যাইহোক  :  যাইহোক
যন্ত্রপাতি  :  যন্ত্রপাতি
যথেচ্ছাভাবে  :  যথেচ্ছাভাব
যথার্থভাবে  :  যথার্থভাব
যথার্থ  :  যথার্থ
যথারীতি  :  যথারীতি
যত্নের  :  যত্ন
যখেরডাঙ্গা  :  যখেরডাঙ্গা
যক্ষ  :  যক্ষ
মৎস্য  :  মৎস্য
ম্রোহং  :  ম্রোহং
ম্যাক্সমুলারের  :  ম্যাক্সমুলার
মৌসুমে  :  মৌসুম
মৌসুম  :  মৌসুম
মৌর্যরীতির  :  মৌর্যরীতি
মোহনা  :  মোহনা
মোস্তাকিমবিল্লাহ্  :  মোস্তাকিমবিল্লাহ্
মোল্লা  :  মোল্লা
মোটের  :  মোট
মোটা  :  মোটা
মোচপোল  :  মোচপোল
মোগলরাও  :  মোগলরাও
মোকাম্মেল  :  মোকাম্মেল
মোকাবেলা  :  মোকাবেলা
মৈত্রেয়  :  মৈত্রেয়
মেলা  :  মেলা
মেয়াদকাল  :  মেয়াদকাল
মেয়াদ  :  মেয়াদ
মেধার  :  মেধা
মেধাবী  :  মেধাবী
মেগালিথিক  :  মেগালিথিক
মৃৎপাত্রগুলিতে  :  মৃৎপাত্রগুলি
মৃত্যুর  :  মৃত্যু
মূললক্ষ্য  :  মূললক্ষ্য
মূর্তিগুলির  :  মূর্তিগুলি
মূর্তিগুলি  :  মূর্তিগুলি
মূর্তিও  :  মূর্তিও
মুহ্সিনিয়া  :  মুহ্সিনিয়া
মুহম্মদ  :  মুহম্মদ
মুসলিমগণ  :  মুসলিমগণ
মুলক  :  মুলক
মুরতাদ  :  মুরতাদ
মুযারি  :  মুযারি
মুয়ং  :  মুয়ং
মুনশী  :  মুনশী
মুদ্রা্  :  মুদ্রা্
মুদ্রাসমূহের  :  মুদ্রাসমূহ
মুদ্রালিপি  :  মুদ্রালিপি
মুদ্রার  :  মুদ্রা
মুদ্রাতত্ত্ববিদ  :  মুদ্রাতত্ত্ববিদ
মুদ্রাও  :  মুদ্রাও
মুতানাবিব  :  মুতানাবিব
মুড়াটি  :  মুড়া
মুগলদের  :  মুগল
মুখোপাধ্যায়  :  মুখোপাধ্যায়
মুখের  :  মুখ
মুখে  :  মুখ
মুক্তিযুদ্ধের  :  মুক্তিযুদ্ধ
মুক্তিদ্ধোদের  :  মুক্তিদ্ধ
মুওয়াহ্হিদীন  :  মুওয়াহ্হিদীন
মুইন  :  মুইন
মীযান  :  মীযান
মীন  :  মীন
মিহিরের  :  মিহির
মিশ্রিত  :  মিশ্রিত
মিশ্রণ  :  মিশ্রণ
মিশেছে  :  মিশেছ
মিশকাত  :  মিশকাত
মিলে  :  মিল
মির্যা  :  মির্যা
মিরাছ  :  মিরাছ
মিটিয়ে  :  মিটিয়
মিছিলের  :  মিছিল
মি  :  মি
মাহেথ  :  মাহেথ
মাহীসুনের  :  মাহীসুন
মাহিসওয়ার  :  মাহিসওয়া
মালিকানাধীন  :  মালিকানাধীন
মালিককে  :  মালিকড
মালিক  :  মালিক
মালা  :  মালা
মালয়  :  মালয়
মালওয়া  :  মালওয়া
মার্শালকে  :  মার্শালড
মার্চ  :  মার্চ
মার্কুইস  :  মার্কুইস
মাযি  :  মাযি
মামুন  :  মামুন
মানেরী  :  মানেরী
মানুষেরা  :  মানুষ
মানুষ  :  মানুষ
মানবাধিকারও  :  মানবাধিকারও
মানচিত্রের  :  মানচিত্র
মানচিত্রসহ  :  মানচিত্রসহ
মান  :  মান
মাধ্যমিক  :  মাধ্যমিক
মাদ্রাসায়ও  :  মাদ্রাসায়ও
মাদ্রাসায়  :  মাদ্রাসায়
মাদ্রাসাটি  :  মাদ্রাসা
মাদ্রাজেই  :  মাদ্রাজেই
মাথায়  :  মাথায়
মাথাটি  :  মাথা
মাত্রার  :  মাত্রা
মাঠপর্যায়ে  :  মাঠপর্যায়
মাঠ  :  মাঠ
মাটি  :  মাটি
মাঝামাঝি  :  মাঝামাঝি
মাইলের  :  মাইল
মাইলব্যাপী  :  মাইলব্যাপী
মাইয়ু  :  মাইয়ু
মহীশুর  :  মহীশু
মহাস্থানগড়েও  :  মহাস্থানগড়েও
মহাস্থানগড়ে  :  মহাস্থানগড়
মহাস্থানগড়কে  :  মহাস্থানগড়ড
মহাবালিপুরম  :  মহাবালিপুরম
মস্তকাবরণী  :  মস্তকাবরণী
মস্তকবিহীন  :  মস্তকবিহীন
মসজিদের  :  মসজি
মর্যাদায়  :  মর্যাদায়
মর্যাদা  :  মর্যাদা
মরিসন  :  মরিসন
ময়মনসিংহের  :  ময়মনসিংহ
ময়মনসিংহ  :  ময়মনসিংহ
ময়নামতি  :  ময়নামতি
মমিন  :  মমিন
মন্দিরে  :  মন্দির
মন্দিরও  :  মন্দিরও
মন্ত্রী  :  মন্ত্রী
মন্তিক  :  মন্তিক
মন্তব্য  :  মন্তব্য
মন্ডপ  :  মন্ডপ
মন্টেগু  :  মন্টেগু
মনোনীত  :  মনোনীত
মনুষ্য  :  মনুষ্য
মধ্যস্থতা  :  মধ্যস্থতা
মধ্যপ্রাচ্যের  :  মধ্যপ্রাচ্য
মধ্যপ্রস্তর  :  মধ্যপ্রস্ত
মধ্যদিয়ে  :  মধ্যদিয়
মদনপুরের  :  মদনপুর
মথুরা  :  মথুর
মঠে  :  মঠে
মঞ্জুর  :  মঞ্জু
মজুমদারের  :  মজুমদার
মজার  :  মজা
মখদুম  :  মখদুম
মকামাতে  :  মকামা
মকামাত  :  মকামাত
মকবুল  :  মকবুল
মকতবে  :  মকতব
মংডো  :  মংড
ভ্রমণের  :  ভ্রমণ
ভ্রমণকাহিনী  :  ভ্রমণকাহিনী
ভোজবর্মন  :  ভোজবর্মন
ভেসে  :  ভেস
ভেতরের  :  ভেতর
ভেতরই  :  ভেতরই
ভেঙ্গে  :  ভেঙ্গ
ভেঙে  :  ভেঙ
ভূমির  :  ভূমি
ভূমিমালিক  :  ভূমিমালিক
ভূখন্ডে  :  ভূখন্ড
ভূঁইয়া  :  ভূঁইয়া
ভীতসন্ত্রস্ত  :  ভীতসন্ত্রস্ত
ভিন্ন  :  ভিন্ন
ভিতর  :  ভিত
ভিড়  :  ভিড়
ভিটা  :  ভিটা
ভিক্ষুদের  :  ভিক্ষু
ভি  :  ভি
ভাস্কর্যটি  :  ভাস্কর্য
ভাসুবিহার  :  ভাসুবিহা
ভাষায়ও  :  ভাষায়ও
ভাষাপরিবারের  :  ভাষাপরিবার
ভারতকে  :  ভারতড
ভাবনা  :  ভাবনা
ভাব  :  ভাব
ভান্ডারের  :  ভান্ডার
ভান্ডারকারের  :  ভান্ডারকার
ভান্ডার  :  ভান্ডা
ভাত  :  ভাত
ভাঙ্গা  :  ভাঙ্গা
ভাঙ্গনখালির  :  ভাঙ্গনখালি
ভাইস  :  ভাইস
ভষ্মাধার  :  ভষ্মাধা
ভর্তি  :  ভর্তি
ভয়ে  :  ভয়
ভবদেব  :  ভবদেব
ভন্ডারকার  :  ভন্ডারকা
ভন  :  ভন
ভদ্রলোক  :  ভদ্রলোক
ভট্টাশালী  :  ভট্টাশালী
ভট্টশালীর  :  ভট্টশালী
ভঙ্গিতে  :  ভঙ্গি
ভগ্নাবস্থায়  :  ভগ্নাবস্থায়
ভক্তি  :  ভক্তি
ব্লাকিসটোন  :  ব্লাকিসটোন
ব্রাহ্ম  :  ব্রাহ্ম
ব্রাঞ্চ  :  ব্রাঞ্চ
ব্রহ্মগিরি  :  ব্রহ্মগিরি
ব্যারি  :  ব্যারি
ব্যাপী  :  ব্যাপী
ব্যাপকহারে  :  ব্যাপকহার
ব্যানার্জি  :  ব্যানার্জি
ব্যাখ্যার  :  ব্যাখ্যা
ব্যাকরণের  :  ব্যাকরণ
ব্যাংকটিকে  :  ব্যাংকটিড
ব্যাংকটি  :  ব্যাংক
ব্যস্ত  :  ব্যস্ত
ব্যর্থতায়  :  ব্যর্থতায়
ব্যর্থ  :  ব্যর্থ
ব্যয়ভার  :  ব্যয়ভা
ব্যবস্থাপনার  :  ব্যবস্থাপনা
ব্যবস্থাপনাধীন  :  ব্যবস্থাপনাধীন
ব্যবস্থাও  :  ব্যবস্থাও
ব্যবস্থাই  :  ব্যবস্থাই
ব্যবসায়ের  :  ব্যবসায়
ব্যবসায়ীকে  :  ব্যবসায়ীড
ব্যবসায়িক  :  ব্যবসায়িক
ব্যবসাকেন্দ্রে  :  ব্যবসাকেন্দ্র
ব্যবসা  :  ব্যবসা
ব্যতিক্রমধর্মী  :  ব্যতিক্রমধর্মী
ব্যঞ্জনবর্ণের  :  ব্যঞ্জনবর্ণ
ব্যক্তির  :  ব্যক্তি
ব্যক্তিগত  :  ব্যক্তিগত
ব্যক্ত  :  ব্যক্ত
বৌদ্ধযুগের  :  বৌদ্ধযুগ
বৌদ্ধধর্ম  :  বৌদ্ধধর্ম
বোসাউপিউ  :  বোসাউপিউ
বোধিসত্ত্ব  :  বোধিসত্ত্ব
বোধগয়া  :  বোধগয়া
বোধগম্য  :  বোধগম্য
বোদাউপায়ার  :  বোদাউপায়া
বোঝায়  :  বোঝায়
বৈশিষ্ট্যাবলি  :  বৈশিষ্ট্যাবলি
বৈশালী  :  বৈশালী
বৈরাগী  :  বৈরাগী
বৈপ্লবিক  :  বৈপ্লবিক
বৈদেশিক  :  বৈদেশিক
বৈচিত্র্যপূর্ণ  :  বৈচিত্র্যপূর্ণ
বেহারসহ  :  বেহারসহ
বেষ্টিত  :  বেষ্টিত
বেশির  :  বেশি
বেলুচিস্তানসহ  :  বেলুচিস্তানসহ
বেলুচিস্তান  :  বেলুচিস্তান
বেলাবো  :  বেলাব
বেরেলি  :  বেরেলি
বেরারসহ  :  বেরারসহ
বেভারিজ  :  বেভারিজ
বেদির  :  বেদি
বেদি  :  বেদি
বেচা  :  বেচা
বেগলারের  :  বেগলার
বৃহৎ  :  বৃহৎ
বৃদ্ধির  :  বৃদ্ধি
বৃত্তান্তের  :  বৃত্তান্ত
বৃক্ষবিদ্যার  :  বৃক্ষবিদ্যা
বৃক্ষছায়ায়  :  বৃক্ষছায়ায়
বৃক্ষ  :  বৃক্ষ
বুৎপত্তি  :  বুৎপত্তি
বুন্দেলখন্দে  :  বুন্দেলখন্দ
বুদ্ধিমত্তার  :  বুদ্ধিমত্তা
বুদ্ধিবৃত্তিক  :  বুদ্ধিবৃত্তিক
বুদ্ধমূর্তি  :  বুদ্ধমূর্তি
বুথিডং  :  বুথিডং
বুঘরা  :  বুঘর
বীরেন্দ্র  :  বীরেন্দ্
বীজগণিত  :  বীজগণিত
বিহারটির  :  বিহার
বিস্তৃতির  :  বিস্তৃতি
বিস্তারের  :  বিস্তার
বিস্তারিতভাবে  :  বিস্তারিতভাব
বিস্তার  :  বিস্তা
বিষয়েও  :  বিষয়েও
বিষয়টি  :  বিষয়
বিশ্লেষণের  :  বিশ্লেষণ
বিশ্লেষণ  :  বিশ্লেষণ
বিশ্ববিদ্যালয়গুলিতেও  :  বিশ্ববিদ্যালয়গুলিতেও
বিশ্ববিদ্যলয়ে  :  বিশ্ববিদ্যলয়
বিশেষত্ব  :  বিশেষত্ব
বিশেষজ্ঞের  :  বিশেষজ্ঞ
বিশেষজ্ঞগণ  :  বিশেষজ্ঞগণ
বিশালাকায়  :  বিশালাকায়
বিশাল  :  বিশাল
বিলুপ্তি  :  বিলুপ্তি
বিলসার  :  বিলসা
বিরোধে  :  বিরোধ
বিরাট  :  বিরাট
বিরতি  :  বিরতি
বিভ্রান্তির  :  বিভ্রান্তি
বিভ্রান্তি  :  বিভ্রান্তি
বিভাগটি  :  বিভাগ
বিবর্তনের  :  বিবর্তন
বিবরণীতে  :  বিবরণী
বিবরণমূলক  :  বিবরণমূলক
বিপ্লবের  :  বিপ্লব
বিন্যাসের  :  বিন্যাস
বিনিয়োগ  :  বিনিয়োগ
বিনিময়ের  :  বিনিময়
বিধৃত  :  বিধৃত
বিধিবদ্ধ  :  বিধিবদ্ধ
বিধানের  :  বিধান
বিদ্যোৎসাহী  :  বিদ্যোৎসাহী
বিদেশে  :  বিদেশ
বিদেশীদের  :  বিদেশী
বিতাড়িত  :  বিতাড়িত
বিজ্ঞানের  :  বিজ্ঞান
বিজ্ঞানভিত্তিক  :  বিজ্ঞানভিত্তিক
বিজাপুরে  :  বিজাপুর
বিজয়স্তম্ভের  :  বিজয়স্তম্ভ
বিজয়স্তম্ভ  :  বিজয়স্তম্ভ
বিজয়  :  বিজয়
বিচিত্র  :  বিচিত্
বিচারক  :  বিচারক
বিচার  :  বিচা
বিঘ্নিত  :  বিঘ্নিত
বিগত  :  বিগত
বিক্ষিপ্তভাবে  :  বিক্ষিপ্তভাব
বিক্রমশিলাকে  :  বিক্রমশিলাড
বিক্রমপুর  :  বিক্রমপু
বাহিরী  :  বাহিরী
বাহন  :  বাহন
বাসিস্হাটা  :  বাসিস্হাটা
বালিয়া  :  বালিয়া
বার্ষিকীতে  :  বার্ষিকী
বার্ষিক  :  বার্ষিক
বার্মিজ  :  বার্মিজ
বার্মার  :  বার্মা
বার্মায়  :  বার্মায়
বার্জেসের  :  বার্জেস
বার্জেসকে  :  বার্জেসড
বারী  :  বারী
বারবাক  :  বারবাক
বামনপুর  :  বামনপু
বাদ্য  :  বাদ্য
বাণিজ্যসম্ভার  :  বাণিজ্যসম্ভা
বাণিজ্য  :  বাণিজ্য
বাড়তে  :  বাড়
বাজেয়াপ্তকরণ  :  বাজেয়াপ্তকরণ
বাজেয়াপ্ত  :  বাজেয়াপ্ত
বাজানো  :  বাজান
বাছাই  :  বাছাই
বাঙালি  :  বাঙালি
বাক্যবিন্যাসে  :  বাক্যবিন্যাস
বাইশহাট  :  বাইশহাট
বাইশ  :  বাইশ
বাংলো  :  বাংল
বাঁকে  :  বাঁড
বহুমুখী  :  বহুমুখী
বহুকাল  :  বহুকাল
বহন  :  বহন
বস্ত্র  :  বস্ত্
বস্ত্তর  :  বস্ত্ত
বস্ত্তটির  :  বস্ত্ত
বস্ত্তগত  :  বস্ত্তগত
বসানো  :  বসান
বসতিসমূহে  :  বসতিসমূহ
বসতবাড়ি  :  বসতবাড়ি
বলেন  :  বলেন
বলবৎ  :  বলবৎ
বর্ধিত  :  বর্ধিত
বর্ধমান  :  বর্ধমান
বর্তমানকালের  :  বর্তমানকাল
বর্ণের  :  বর্ণ
বর্ণিত  :  বর্ণিত
বর্ণনাসমূহে  :  বর্ণনাসমূহ
বর্ণনায়  :  বর্ণনায়
বর্ণনাত্মক  :  বর্ণনাত্মক
বর্ণনাই  :  বর্ণনাই
বর্জন  :  বর্জন
বর্গাকৃত  :  বর্গাকৃত
বর্গফুট  :  বর্গফুট
বর্গ  :  বর্গ
বরেন্দ্রের  :  বরেন্দ্র
বরাবর  :  বরাব
বরবদুর  :  বরবদু
বয়স  :  বয়স
বন্য  :  বন্য
বন্দরের  :  বন্দর
বন্দরে  :  বন্দর
বন্দরসমূহের  :  বন্দরসমূহ
বন্দরগুলি  :  বন্দরগুলি
বন্দরকে  :  বন্দরড
বনে  :  বনে
বনবিদ্যার  :  বনবিদ্যা
বদ্ধ  :  বদ্ধ
বদাউন  :  বদাউন
বণিকরা  :  বণিকর
বণিকদের  :  বণিক
বণিকগণ  :  বণিকগণ
বণিক  :  বণিক
বটেশ্বরের  :  বটেশ্বর
বটেশ্বরে  :  বটেশ্বর
বজ্রসত্ত্বটি  :  বজ্রসত্ত্ব
বজ্রসত্ত্ব  :  বজ্রসত্ত্ব
বজরা  :  বজরা
বছরেরও  :  বছরেরও
বছরে  :  বছর
বচন  :  বচন
বঙ্গোপসাগর  :  বঙ্গোপসাগ
বঙ্গানুবাদ  :  বঙ্গানুবাদ
বঙ্গ  :  বঙ্গ
বকুলতলায়  :  বকুলতলায়
বইয়ের  :  বইয়
বই  :  বই
বংশবৃত্তান্তে  :  বংশবৃত্তান্
বংশধররা  :  বংশধরর
বংশ  :  বংশ
ব  :  ব
ফ্লিট  :  ফ্লিট
ফেলার  :  ফেলা
ফেলা  :  ফেলা
ফেলতেন  :  ফেলতেন
ফেব্রুয়ারি  :  ফেব্রুয়ারি
ফুল  :  ফুল
ফুরারের  :  ফুরার
ফুরার  :  ফুরা
ফুটেরও  :  ফুটেরও
ফুটিয়ে  :  ফুটিয়
ফী  :  ফী
ফিল  :  ফিল
ফিরিয়ে  :  ফিরিয়
ফিক্হশাস্ত্রে  :  ফিক্হশাস্ত্র
ফিক্হশাস্ত্র  :  ফিক্হশাস্ত্
ফার্সি  :  ফার্সি
ফার্ম  :  ফার্ম
ফারসিতে  :  ফারসি
ফান্ডের  :  ফান্ড
ফাঁপা  :  ফাঁপা
ফসলাদি  :  ফসলাদি
ফসল  :  ফসল
ফল্সফা  :  ফল্সফা
ফলাফলেরও  :  ফলাফলেরও
ফলাফলের  :  ফলাফল
ফলাদি  :  ফলাদি
ফলপ্রসূ  :  ফলপ্রসূ
ফলকের  :  ফলক
ফলকও  :  ফলকও
ফরজ  :  ফরজ
ফতেয়াবাদ  :  ফতেয়াবাদ
ফতেপুর  :  ফতেপু
প্রেসিডেন্ট  :  প্রেসিডেন্ট
প্রিন্সিপকে  :  প্রিন্সিপড
প্রাসাদ  :  প্রাসাদ
প্রার্থনার  :  প্রার্থনা
প্রায়োগিক  :  প্রায়োগিক
প্রামাণিক  :  প্রামাণিক
প্রাপ্তি  :  প্রাপ্তি
প্রান্তে  :  প্রান্
প্রান্তভাগে  :  প্রান্তভাগ
প্রাণীর  :  প্রাণী
প্রাচুর্যপূর্ণ  :  প্রাচুর্যপূর্ণ
প্রাচীনত্বের  :  প্রাচীনত্ব
প্রাচীনত্ব  :  প্রাচীনত্ব
প্রাচীনকালে  :  প্রাচীনকাল
প্রাচীনকাল  :  প্রাচীনকাল
প্রস্ত্তত  :  প্রস্ত্তত
প্রস্তাবের  :  প্রস্তাব
প্রস্তাবে  :  প্রস্তাব
প্রস্তাবকে  :  প্রস্তাবড
প্রসারিত  :  প্রসারিত
প্রসঙ্গে  :  প্রসঙ্গ
প্রসঙ্গত  :  প্রসঙ্গত
প্রসঙ্গ  :  প্রসঙ্গ
প্রশ্নে  :  প্রশ্ন
প্রশিক্ষিত  :  প্রশিক্ষিত
প্রশিক্ষণের  :  প্রশিক্ষণ
প্রশাসক  :  প্রশাসক
প্রশাখা  :  প্রশাখা
প্রশস্ত  :  প্রশস্ত
প্রশংসা  :  প্রশংসা
প্রয়োজনীয়তা  :  প্রয়োজনীয়তা
প্রমুখ  :  প্রমুখ
প্রমাণাদির  :  প্রমাণাদি
প্রমাণও  :  প্রমাণও
প্রভিন্স  :  প্রভিন্স
প্রভাষচন্দ্র  :  প্রভাষচন্দ্
প্রভাবের  :  প্রভাব
প্রভাবিত  :  প্রভাবিত
প্রবেশ্যতা  :  প্রবেশ্যতা
প্রবাদ  :  প্রবাদ
প্রবর্তিত  :  প্রবর্তিত
প্রবর্তনে  :  প্রবর্তন
প্রধানদের  :  প্রধান
প্রদেশসমূহ  :  প্রদেশসমূহ
প্রদীপ  :  প্রদীপ
প্রদানের  :  প্রদান
প্রদানে  :  প্রদান
প্রদর্শিত  :  প্রদর্শিত
প্রদর্শনের  :  প্রদর্শন
প্রদর্শন  :  প্রদর্শন
প্রথমবারের  :  প্রথমবার
প্রথমটির  :  প্রথম
প্রত্যেকটির  :  প্রত্যেক
প্রত্যেকটি  :  প্রত্যেক
প্রত্নস্থলটিতে  :  প্রত্নস্থল
প্রত্নস্থলগুলিও  :  প্রত্নস্থলগুলিও
প্রত্নস্থলগুলি  :  প্রত্নস্থলগুলি
প্রত্নবস্ত্তসমূহ  :  প্রত্নবস্ত্তসমূহ
প্রত্নবস্ত্তটি  :  প্রত্নবস্ত্ত
প্রত্নতত্ত্ববিদের  :  প্রত্নতত্ত্ববি
প্রত্নতত্ত্ববিদগণ  :  প্রত্নতত্ত্ববিদগণ
প্রত্নতত্ত্ববিদ  :  প্রত্নতত্ত্ববিদ
প্রত্নতত্ত্বকে  :  প্রত্নতত্ত্বড
প্রত্নচর্চার  :  প্রত্নচর্চা
প্রত্নক্ষেত্রকে  :  প্রত্নক্ষেত্রড
প্রত্নকীর্তিটির  :  প্রত্নকীর্তি
প্রত্নকীর্তি  :  প্রত্নকীর্তি
প্রত্নএলাকা  :  প্রত্নএলাকা
প্রত্নঅঞ্চলটির  :  প্রত্নঅঞ্চল
প্রত্নঅঞ্চলটি  :  প্রত্নঅঞ্চল
প্রতীয়মান  :  প্রতীয়মান
প্রতিষ্ঠালগ্ন  :  প্রতিষ্ঠালগ্ন
প্রতিষ্ঠানে  :  প্রতিষ্ঠান
প্রতিষঙ্গী  :  প্রতিষঙ্গী
প্রতিশ্রুতি  :  প্রতিশ্রুতি
প্রতিরক্ষা  :  প্রতিরক্ষা
প্রতিমূর্তির  :  প্রতিমূর্তি
প্রতিমা  :  প্রতিমা
প্রতিভা  :  প্রতিভা
প্রতিবেশী  :  প্রতিবেশী
প্রতিবেদনের  :  প্রতিবেদন
প্রতিবেদনে  :  প্রতিবেদন
প্রতিবেদনও  :  প্রতিবেদনও
প্রতিবছর  :  প্রতিবছ
প্রতিদিনের  :  প্রতিদিন
প্রণয়নের  :  প্রণয়ন
প্রডাক্ট  :  প্রডাক্ট
প্রচারে  :  প্রচার
প্রচারকগণ  :  প্রচারকগণ
প্রক্রিয়া  :  প্রক্রিয়া
প্রকৌশলীর  :  প্রকৌশলী
প্রকৌশল  :  প্রকৌশল
প্রকৃতপক্ষে  :  প্রকৃতপক্ষ
প্রকাশনার  :  প্রকাশনা
প্যাগান  :  প্যাগান
পৌরাণিক  :  পৌরাণিক
পৌরবিজ্ঞান  :  পৌরবিজ্ঞান
পৌঁছেছিল  :  পৌঁছেছিল
পৌঁছাত  :  পৌঁছাত
পোড়ামাটি  :  পোড়ামা
পোড়া  :  পোড়া
পেত  :  পেত
পেছনের  :  পেছন
পেছনে  :  পেছন
পেঁপে  :  পেঁপ
পৃষ্ঠপোষকতা  :  পৃষ্ঠপোষকতা
পৃষ্ঠ  :  পৃষ্ঠ
পৃথক  :  পৃথক
পূর্বেই  :  পূর্বেই
পূর্বাংশের  :  পূর্বাংশ
পূর্বাংশে  :  পূর্বাংশ
পূর্বপুরুষরা  :  পূর্বপুরুষর
পূর্বপুরুষদের  :  পূর্বপুরুষ
পূর্বপুরুষ  :  পূর্বপুরুষ
পূর্বপাশের  :  পূর্বপাশ
পূর্ত  :  পূর্ত
পূর্ণাঙ্গ  :  পূর্ণাঙ্গ
পূজক  :  পূজক
পূ  :  পূ
পুষ্পাধার  :  পুষ্পাধা
পুষ্প  :  পুষ্প
পুষিয়ে  :  পুষিয়
পুরুষের  :  পুরুষ
পুরুষাকৃতির  :  পুরুষাকৃতি
পুরু  :  পুরু
পুরাবস্ত্ত  :  পুরাবস্ত্ত
পুরাকীর্তির  :  পুরাকীর্তি
পুরস্কৃত  :  পুরস্কৃত
পুন্ড্রবর্ধন  :  পুন্ড্রবর্ধন
পুন্ড্রনগরসহ  :  পুন্ড্রনগরসহ
পুনর্দখল  :  পুনর্দখল
পুনর্জীবিত  :  পুনর্জীবিত
পুনর্গঠন  :  পুনর্গঠন
পুনরুজ্জীবিত  :  পুনরুজ্জীবিত
পুনরুজ্জীবনে  :  পুনরুজ্জীবন
পুনঃসংগঠিত  :  পুনঃসংগঠিত
পুনঃপ্রবর্তন  :  পুনঃপ্রবর্তন
পুনঃপ্রতিষ্ঠার  :  পুনঃপ্রতিষ্ঠা
পুনঃনির্ধারিত  :  পুনঃনির্ধারিত
পুন  :  পুন
পুত্র  :  পুত্
পুকুরতলা  :  পুকুরতলা
পুকুর  :  পুকু
পুঁতি  :  পুঁতি
পি  :  পি
পাহাড়  :  পাহাড়
পাস  :  পাস
পাশে  :  পাশ
পাশা  :  পাশা
পাশ  :  পাশ
পাল্টে  :  পাল্ট
পার্শ্বনাথ  :  পার্শ্বনাথ
পার্কও  :  পার্কও
পারিবারিক  :  পারিবারিক
পারদর্শিতা  :  পারদর্শিতা
পায়  :  পায়
পাবলিকেশন্সের  :  পাবলিকেশন্স
পাবনার  :  পাবনা
পান্ডুলিপি  :  পান্ডুলিপি
পান্ডিত্যের  :  পান্ডিত্য
পানীয়জলের  :  পানীয়জল
পান  :  পান
পাত্রগুলি  :  পাত্রগুলি
পাত্রও  :  পাত্রও
পাতার  :  পাতা
পাতলা  :  পাতলা
পাতকুয়া  :  পাতকুয়া
পাত  :  পাত
পাড়ের  :  পাড়
পাঠ্যসূচির  :  পাঠ্যসূচি
পাঠ্যসূচিতে  :  পাঠ্যসূচি
পাঠে  :  পাঠ
পাঠানরা  :  পাঠানর
পাঠন  :  পাঠন
পাঠদান  :  পাঠদান
পাটালিপুত্র  :  পাটালিপুত্
পাট  :  পাট
পাচরুখি  :  পাচরুখি
পাগড়ি  :  পাগড়ি
পাখা  :  পাখা
পাকিস্তানের  :  পাকিস্তান
পাকবাহিনী  :  পাকবাহিনী
পাক  :  পাক
পশ্চিমাঞ্চল  :  পশ্চিমাঞ্চল
পশ্চাৎপদ  :  পশ্চাৎপদ
পল্লী  :  পল্লী
পল্লিবিদ্যুতায়ন  :  পল্লিবিদ্যুতায়ন
পর্ষদ  :  পর্ষদ
পর্যস্ত  :  পর্যস্ত
পর্যবেক্ষণসমূহ  :  পর্যবেক্ষণসমূহ
পর্যবেক্ষণ  :  পর্যবেক্ষণ
পর্যবসিত  :  পর্যবসিত
পর্যটকগণ  :  পর্যটকগণ
পর্বতশৃঙ্গ  :  পর্বতশৃঙ্গ
পরীক্ষায়  :  পরীক্ষায়
পরীক্ষণ  :  পরীক্ষণ
পরিহিত  :  পরিহিত
পরিস্ফুটিত  :  পরিস্ফুটিত
পরিস্থিতি  :  পরিস্থিতি
পরিসমাপ্তি  :  পরিসমাপ্তি
পরিষৎটিতে  :  পরিষৎ
পরিষৎ  :  পরিষৎ
পরিষদের  :  পরিষ
পরিশ্রমী  :  পরিশ্রমী
পরিলক্ষিত  :  পরিলক্ষিত
পরিমাপন  :  পরিমাপন
পরিভাষায়  :  পরিভাষায়
পরিব্রাজক  :  পরিব্রাজক
পরিবর্ধন  :  পরিবর্ধন
পরিপূরণের  :  পরিপূরণ
পরিপার্শ্ব  :  পরিপার্শ্ব
পরিধি  :  পরিধি
পরিদর্শনের  :  পরিদর্শন
পরিচ্ছদ  :  পরিচ্ছদ
পরিচয়বাহী  :  পরিচয়বাহী
পরিকল্পিত  :  পরিকল্পিত
পরিকল্পনাকে  :  পরিকল্পনাড
পরস্পরের  :  পরস্পর
পরপরই  :  পরপরই
পরগণার  :  পরগণা
পরও  :  পরও
পরই  :  পরই
পন্ডিতব্যক্তি  :  পন্ডিতব্যক্তি
পন্ডিতদের  :  পন্ডিত
পন্ডিত  :  পন্ডিত
পন্ডিচেরির  :  পন্ডিচেরি
পদ্যে  :  পদ্য
পদ্মাবতী  :  পদ্মাবতী
পদ্ধতিরও  :  পদ্ধতিরও
পদ্ধতিতে  :  পদ্ধতি
পদত্যাগ  :  পদত্যাগ
পদগুলো  :  পদগুল
পথে  :  পথে
পথপ্রদর্শকের  :  পথপ্রদর্শক
পত্রিকায়  :  পত্রিকায়
পড়েছিল  :  পড়েছিল
পড়ানো  :  পড়ান
পট্টিকেরা  :  পট্টিক
পটিয়ার  :  পটিয়া
পটভূমিতে  :  পটভূমি
পঞ্চাশ  :  পঞ্চাশ
পঞ্চপ্রদীপ  :  পঞ্চপ্রদীপ
পঞ্চ  :  পঞ্চ
পক্ষেও  :  পক্ষেও
পক্ষান্তরে  :  পক্ষান্তর
পক্ষকে  :  পক্ষড
নোয়াখালীর  :  নোয়াখালী
নোয়াখালীতে  :  নোয়াখালী
নোটিশের  :  নোটিশ
নোটিশ  :  নোটিশ
নৈকট্যের  :  নৈকট্য
নেমিনাথ  :  নেমিনাথ
নেপালসহ  :  নেপালসহ
নেতৃবৃন্দের  :  নেতৃবৃন্
নেতৃত্ব  :  নেতৃত্ব
নেওয়া  :  নেওয়া
নূতন  :  নূতন
নুড়িময়  :  নুড়িময়
নীতিসমূহ  :  নীতিসমূহ
নীতিমালা  :  নীতিমালা
নীতিবিদ্যা  :  নীতিবিদ্যা
নিহত  :  নিহত
নিষ্পত্তি  :  নিষ্পত্তি
নিষ্কাশন  :  নিষ্কাশন
নিশ্চিন্ত  :  নিশ্চিন্ত
নিশ্চিতকরণের  :  নিশ্চিতকরণ
নিশ্চিতকরণ  :  নিশ্চিতকরণ
নিশাপুরী  :  নিশাপুরী
নিলোর  :  নিল
নির্মাতা  :  নির্মাতা
নির্ভরশীল  :  নির্ভরশীল
নির্বাহী  :  নির্বাহী
নির্ধারিত  :  নির্ধারিত
নির্ধারণের  :  নির্ধারণ
নির্দেশের  :  নির্দেশ
নির্দেশে  :  নির্দেশ
নির্দেশনার  :  নির্দেশনা
নির্দশন  :  নির্দশন
নির্ণয়  :  নির্ণয়
নিরূপণের  :  নিরূপণ
নিরূপণ  :  নিরূপণ
নিরীক্ষা  :  নিরীক্ষা
নিযুক্তির  :  নিযুক্তি
নিযুক্তি  :  নিযুক্তি
নিযামউদ্দীন  :  নিযামউদ্দীন
নিয়োজিত  :  নিয়োজিত
নিয়োগকৃত  :  নিয়োগকৃত
নিয়মিতভাবে  :  নিয়মিতভাব
নিয়মাবলী  :  নিয়মাবলী
নিয়ন্ত্রিত  :  নিয়ন্ত্রিত
নিয়ন্ত্রণে  :  নিয়ন্ত্রণ
নিম্নভাবে  :  নিম্নভাব
নিম্ন  :  নিম্ন
নিবেদিত  :  নিবেদিত
নিবন্ধন  :  নিবন্ধন
নিন্দা  :  নিন্দা
নিদর্শসসমূহ  :  নিদর্শসসমূহ
নিদর্শনগুলিও  :  নিদর্শনগুলিও
নিদর্শনগুলি  :  নিদর্শনগুলি
নিদর্শনই  :  নিদর্শনই
নাহ্ওমীর  :  নাহ্ওমী
নাহ্ও  :  নাহ্ও
নাসিরুদ্দীন  :  নাসিরুদ্দীন
নালগোরা  :  নালগোর
নার্সারি  :  নার্সারি
নারীর  :  নারী
নারায়ণগঞ্জ  :  নারায়ণগঞ্জ
নামানুসারে  :  নামানুসার
নামটি  :  নাম
নামকরণও  :  নামকরণও
নাফ  :  নাফ
নাগরিকের  :  নাগরিক
নাগরিকত্ব  :  নাগরিকত্ব
নাগরিক  :  নাগরিক
নাগপুরসহ  :  নাগপুরসহ
নস্র  :  নস্
নষ্ট  :  নষ্ট
নলিনীকান্ত  :  নলিনীকান্ত
নলকূপ  :  নলকূপ
নর্মদা  :  নর্মদা
নর্তকী  :  নর্তকী
নরসিংদীতে  :  নরসিংদী
নরমিখলা  :  নরমিখলা
নয়ল  :  নয়ল
নয়টি  :  নয়
নব্যপ্রস্তর  :  নব্যপ্রস্ত
নব্য  :  নব্য
নতুনত্ব  :  নতুনত্ব
নগরের  :  নগর
নগরসমূহের  :  নগরসমূহ
নগরকেন্দ্র  :  নগরকেন্দ্
নকশাকার  :  নকশাকা
নকল  :  নকল
নওয়াবগঞ্জ  :  নওয়াবগঞ্জ
নওগাঁর  :  নওগাঁ
ধ্রুপদী  :  ধ্রুপদী
ধ্বনিবিজ্ঞান  :  ধ্বনিবিজ্ঞান
ধ্বংসাবশেষকে  :  ধ্বংসাবশেষড
ধ্বংসস্তুপ  :  ধ্বংসস্তুপ
ধ্বংসসাধনের  :  ধ্বংসসাধন
ধূসর  :  ধূস
ধূপধুনা  :  ধূপধুনা
ধীবর  :  ধীব
ধারাকেও  :  ধারাকেও
ধারণায়  :  ধারণায়
ধারণাই  :  ধারণাই
ধারণ  :  ধারণ
ধাতব  :  ধাতব
ধর্মাবলম্বীদের  :  ধর্মাবলম্বী
ধর্মপ্রচারে  :  ধর্মপ্রচার
ধর্মপালদেব  :  ধর্মপালদেব
ধর্মপাল  :  ধর্মপাল
ধরপাকড়  :  ধরপাকড়
ধবংসের  :  ধবংস
ধতংসাবশেষের  :  ধতংসাবশেষ
দ্রাবিড়  :  দ্রাবিড়
দ্রাঘিমাংশ  :  দ্রাঘিমাংশ
দ্রব্যাদি  :  দ্রব্যাদি
দ্রব্য  :  দ্রব্য
দ্বৈত  :  দ্বৈত
দ্বীপে  :  দ্বীপ
দ্বীপ  :  দ্বীপ
দ্বিতীয়টির  :  দ্বিতীয়
দ্বিতল  :  দ্বিতল
দৌলা  :  দৌলা
দৈনিক  :  দৈনিক
দৈনন্দিন  :  দৈনন্দিন
দৈত্য  :  দৈত্য
দেহের  :  দেহ
দেহাবশেষের  :  দেহাবশেষ
দেশিয়  :  দেশিয়
দেশি  :  দেশি
দেশসমূহ  :  দেশসমূহ
দেশকে  :  দেশড
দেশ  :  দেশ
দেয়াল  :  দেয়াল
দেয়ার  :  দেয়া
দেবেন  :  দেবেন
দেবমূর্তির  :  দেবমূর্তি
দেবপূজার  :  দেবপূজা
দেবতা  :  দেবতা
দেবখড়গের  :  দেবখড়গ
দেখাশুনার  :  দেখাশুনা
দেখায়নি  :  দেখায়
দৃষ্টিভঙ্গির  :  দৃষ্টিভঙ্গি
দৃষ্টি  :  দৃষ্
দৃষ্টান্তস্বরূপ  :  দৃষ্টান্তস্বরূপ
দৃশ্যমান  :  দৃশ্যমান
দৃশ্যচিত্রের  :  দৃশ্যচিত্র
দৃঢ়  :  দৃঢ়
দূরত্ব  :  দূরত্ব
দুষ্প্রাপ্য  :  দুষ্প্রাপ্য
দুলকি  :  দুলকি
দুর্বলতার  :  দুর্বলতা
দুর্গা  :  দুর্গা
দুর্গসমূহ  :  দুর্গসমূহ
দুর্গরক্ষক  :  দুর্গরক্ষক
দুর্গও  :  দুর্গও
দুযুগ  :  দুযুগ
দুভাগে  :  দুভাগ
দুপর্যায়ে  :  দুপর্যায়
দুটির  :  দুটি
দুজন  :  দুজন
দুওয়াম  :  দুওয়াম
দুইভাগে  :  দুইভাগ
দুঃসাধ্য  :  দুঃসাধ্য
দীর্ঘমেয়াদি  :  দীর্ঘমেয়াদি
দীর্ঘদিন  :  দীর্ঘদিন
দীপমালা  :  দীপমালা
দীন  :  দীন
দীউয়ানি  :  দীউয়া
দিল্লী  :  দিল্লী
দিল্লির  :  দিল্লি
দিলিপ  :  দিলিপ
দিয়েছে  :  দিয়েছ
দিয়াফত  :  দিয়াফত
দিবে  :  দিব
দিনে  :  দিন
দিনাজপুর  :  দিনাজপু
দিন  :  দিন
দিতে  :  দিত
দিঘির  :  দিঘি
দিঘি  :  দিঘি
দিঘাপতিয়ার  :  দিঘাপতিয়া
দিগম্বর  :  দিগম্ব
দিগন্ত  :  দিগন্ত
দিকের  :  দিক
দিওয়ান  :  দিওয়ান
দি  :  দি
দালিলিক  :  দালিলিক
দালানকোঠার  :  দালানকোঠা
দারোগাসহ  :  দারোগাসহ
দায়িত্বে  :  দায়িত্ব
দায়িত্বও  :  দায়িত্বও
দায়ভাগ  :  দায়ভাগ
দামের  :  দাম
দামী  :  দামী
দানাদার  :  দানাদা
দানবাকৃতির  :  দানবাকৃতি
দানব  :  দানব
দাঁতের  :  দাঁত
দলিল  :  দলিল
দলবদ্ধ  :  দলবদ্ধ
দলনেতা  :  দলনেতা
দল  :  দল
দরবারে  :  দরবার
দরগাঁও  :  দরগাঁও
দয়ারাম  :  দয়ারাম
দন্ডের  :  দন্ড
দন্ডে  :  দন্ড
দন্ডিত  :  দন্ডিত
দন্ডায়মান  :  দন্ডায়মান
দন্ডই  :  দন্ডই
দখলের  :  দখল
দখলে  :  দখল
দখল  :  দখল
দক্ষিণের  :  দক্ষিণ
দক্ষিণপূর্ব  :  দক্ষিণপূর্ব
দক্ষতাসহ  :  দক্ষতাসহ
দক্ষতায়  :  দক্ষতায়
দক্ষতা  :  দক্ষতা
দক্ষ  :  দক্ষ
দ  :  দ
থু  :  থু
থান  :  থান
থাদোমেন্তরের  :  থাদোমেন্তর
থাকার  :  থাকা
থাকা  :  থাকা
থাকলে  :  থাকল
থাকতেন  :  থাকতেন
তৎকালে  :  তৎকাল
ত্রিরথ  :  ত্রিরথ
ত্রয়  :  ত্রয়
তোলেন  :  তোলেন
তোলে  :  তোল
তোলা  :  তোলা
তৈরিতে  :  তৈরি
তেলাওয়াত  :  তেলাওয়াত
তেমনিভাবে  :  তেমনিভাব
তেমনি  :  তেম
তুহফাতুল্  :  তুহফাতুল্
তুলনায়  :  তুলনায়
তীরের  :  তীর
তিনিই  :  তিনিই
তাৎপর্যের  :  তাৎপর্য
তাৎপর্য  :  তাৎপর্য
তাসত্ত্বেও  :  তাসত্ত্বেও
তারিখে  :  তারিখ
তারও  :  তারও
তায়িং  :  তায়িং
তাম্রশাসনের  :  তাম্রশাসন
তাম্রশাসনটি  :  তাম্রশাসন
তাম্রলিপ্তিই  :  তাম্রলিপ্তিই
তাম্র  :  তাম্
তামার  :  তামা
তামা  :  তামা
তামবুকিয়া  :  তামবুকিয়া
তাফসীরুফত্হিল  :  তাফসীরুফত্হিল
তাফসিরও  :  তাফসিরও
তাদেরকে  :  তাদেরড
তাত্ত্বিক  :  তাত্ত্বিক
তাজমহল  :  তাজমহল
তাছাড়া  :  তাছাড়া
তাকে  :  তাক
তাওহিদ  :  তাওহিদ
তাঁদের  :  তাঁ
তাঁতশিল্প  :  তাঁতশিল্প
তস্করবৃত্তির  :  তস্করবৃত্তি
তলোয়ার  :  তলোয়া
তলানিই  :  তলানিই
তমলুকে  :  তমলুড
তথ্যসূত্র  :  তথ্যসূত্
তত্ত্বাবধানে  :  তত্ত্বাবধান
তক্ষশীলা  :  তক্ষশীলা
তকীউদ্দীন  :  তকীউদ্দীন
তওয়ামা  :  তওয়ামা
তইং  :  তইং
ঢোল  :  ঢোল
ঢিবিসমূহ  :  ঢিবিসমূহ
ঢিবির  :  ঢিবি
ঢিবিতে  :  ঢিবি
ঢিবিকে  :  ঢিবিড
ঢাকায়  :  ঢাকায়
ঢাক  :  ঢাক
ডোমিনিয়নের  :  ডোমিনিয়ন
ডেবিট  :  ডেবিট
ডিভোলিউশন  :  ডিভোলিউশন
ডিক্রি  :  ডিক্রি
ডিউক  :  ডিউক
ডানা  :  ডানা
ডাকের  :  ডাক
ডাকাতদের  :  ডাকাত
ডাইসন  :  ডাইসন
ঠিকাদারদের  :  ঠিকাদার
ট্রিটমেন্টের  :  ট্রিটমেন্ট
ট্যাপ  :  ট্যাপ
টেকনিক্যাল  :  টেকনিক্যাল
টিরও  :  টিরও
টানিয়ে  :  টানিয়
টাকায়  :  টাকায়
টাউনে  :  টাউন
টন  :  টন
ঝুঁকিপূর্ণ  :  ঝুঁকিপূর্ণ
জ্যোতিষতত্ত্ব  :  জ্যোতিষতত্ত্ব
জ্যোতির্বিজ্ঞান  :  জ্যোতির্বিজ্ঞান
জ্যাসপার  :  জ্যাসপা
জ্যামিতি  :  জ্যামিতি
জ্ঞাপন  :  জ্ঞাপন
জ্ঞানের  :  জ্ঞান
জ্ঞানার্জন  :  জ্ঞানার্জন
জ্ঞানসম্পন্ন  :  জ্ঞানসম্পন্ন
জৌনপুরের  :  জৌনপুর
জোর  :  জোর
জোনস  :  জোনস
জৈন্তিয়ার  :  জৈন্তিয়া
জৈনতীর্থঙ্কর  :  জৈনতীর্থঙ্ক
জেলায়  :  জেলায়
জুলাই  :  জুলাই
জীবিত  :  জীবিত
জীবনে  :  জীবন
জীবনধারার  :  জীবনধারা
জীবনচিত্র  :  জীবনচিত্
জীবন  :  জীবন
জিব্রালটার  :  জিব্রালটা
জিনিসপত্রগুলি  :  জিনিসপত্রগুলি
জিনিসও  :  জিনিসও
জিন  :  জিন
জিকরা  :  জিকর
জাহাজগুলিকে  :  জাহাজগুলিড
জাহাজ  :  জাহাজ
জাল  :  জাল
জার্নাল  :  জার্নাল
জারী  :  জারী
জারি  :  জারি
জায়েদ  :  জায়েদ
জায়সীর  :  জায়সী
জায়গা  :  জায়গা
জামে  :  জাম
জামিয়া  :  জামিয়া
জাম  :  জাম
জাফরির  :  জাফরি
জাফরাবাদ  :  জাফরাবাদ
জাপানের  :  জাপান
জানিয়েছিলেন  :  জানিয়েছিলেন
জানানোর  :  জানান
জাদুঘরের  :  জাদুঘর
জাদুঘরে  :  জাদুঘর
জাদুঘরটি  :  জাদুঘর
জাতিতাত্ত্বিক  :  জাতিতাত্ত্বিক
জাঙ্গলিয়া  :  জাঙ্গলিয়া
জাঁহাপুর  :  জাঁহাপু
জলাশয়  :  জলাশয়
জলবায়ু  :  জলবায়ু
জলপূর্ণ  :  জলপূর্ণ
জলধারণ  :  জলধারণ
জলতাত্ত্বিকভাবে  :  জলতাত্ত্বিকভাব
জল  :  জল
জরুরি  :  জরুরি
জরিপসমূহের  :  জরিপসমূহ
জরিপসমূহ  :  জরিপসমূহ
জরিপকার  :  জরিপকা
জয়  :  জয়
জমিদারের  :  জমিদার
জমায়  :  জমায়
জমতে  :  জমত
জন্যও  :  জন্যও
জন্যই  :  জন্যই
জন্তুর  :  জন্তু
জনে  :  জনে
জনাব  :  জনাব
জনসংখ্যার  :  জনসংখ্যা
জনশক্তি  :  জনশক্তি
জনবসতি  :  জনবসতি
জনপ্রিয়  :  জনপ্রিয়
জনপথ  :  জনপথ
জটিল  :  জটিল
জঙ্গলের  :  জঙ্গল
জঙ্গলী  :  জঙ্গলী
জঙ্গল  :  জঙ্গল
জগদ্দলের  :  জগদ্দল
জগদ্দল  :  জগদ্দল
ছোটখাট  :  ছোটখাট
ছেড়ে  :  ছেড়
ছিদ্র  :  ছিদ্
ছিটিয়ে  :  ছিটিয়
ছাপানোর  :  ছাপান
ছাদের  :  ছাদ
ছাদ  :  ছাদ
ছাত্রীরা  :  ছাত্রীর
ছাত্রদের  :  ছাত্র
ছাগলনাইয়াতে  :  ছাগলনাইয়া
ছাঁচ  :  ছাঁচ
ছয়  :  ছয়
ছড়িয়ে  :  ছড়িয়
ছক  :  ছক
চৌধুরীর  :  চৌধুরী
চৌধুরী  :  চৌধুরী
চৌদ্দ  :  চৌদ্দ
চোখে  :  চোখ
চৈত্য  :  চৈত্য
চৈতন্যের  :  চৈতন্য
চেয়েও  :  চেয়েও
চেয়ারম্যানের  :  চেয়ারম্যান
চেম্সফোর্ড  :  চেম্সফোর্ড
চূড়ান্ত  :  চূড়ান্ত
চুরি  :  চুরি
চুয়ায়  :  চুয়ায়
চুনাপাথর  :  চুনাপাথ
চুড়িহাট্টা  :  চুড়িহাট্টা
চুক্তিভঙ্গের  :  চুক্তিভঙ্গ
চীনামাটি  :  চীনামা
চিহ্নিত  :  চিহ্নিত
চিহ্ন  :  চিহ্ন
চিনা  :  চিনা
চিত্রায়িত  :  চিত্রায়িত
চিত্রসহ  :  চিত্রসহ
চিত্তাকর্ষক  :  চিত্তাকর্ষক
চিটাগাং  :  চিটাগাং
চিকিৎসাবিজ্ঞান  :  চিকিৎসাবিজ্ঞান
চাহিদা  :  চাহিদা
চাষ  :  চাষ
চালানো  :  চালান
চালান  :  চালান
চালাতে  :  চালা
চালা  :  চালা
চারা  :  চারা
চারশ  :  চারশ
চার  :  চার
চামুন্ডা  :  চামুন্ডা
চানহুডারোতে  :  চানহুডার
চাছুঁনি  :  চাছুঁ
চাকলাপুঞ্জিতে  :  চাকলাপুঞ্জি
চাকরি  :  চাকরি
চল্লিশের  :  চল্লিশ
চলতে  :  চলত
চলছে  :  চলছ
চরিত্র  :  চরিত্
চম্পাদেউলিয়া  :  চম্পাদেউলিয়া
চন্দ্রের  :  চন্দ্র
চন্দ্রকেতুগড়ে  :  চন্দ্রকেতুগড়
চন্দন  :  চন্দন
চন্দ  :  চন্দ
চত্বরযুক্ত  :  চত্বরযুক্ত
চতুর্ভুজাকৃতির  :  চতুর্ভুজাকৃতি
চতুর্ভুজাকৃতি  :  চতুর্ভুজাকৃতি
চতুর্ভুজাকার  :  চতুর্ভুজাকা
চক্রবর্তীর  :  চক্রবর্তী
চক্রবর্তী  :  চক্রবর্তী
ঙ  :  ঙ
ঘোষিত  :  ঘোষিত
ঘোষণার  :  ঘোষণা
ঘোরানো  :  ঘোরান
ঘোপার  :  ঘোপা
ঘিরে  :  ঘির
ঘাস  :  ঘাস
ঘাটি  :  ঘাটি
ঘাটনগর  :  ঘাটনগ
ঘাটতি  :  ঘাটতি
ঘাঁটি  :  ঘাঁ
ঘনিষ্ট  :  ঘনিষ্ট
ঘণ্টাটির  :  ঘণ্টা
ঘণ্টা  :  ঘণ্টা
ঘটেছে  :  ঘটেছ
ঘটানো  :  ঘটান
ঘটনাবলি  :  ঘটনাবলি
ঘ  :  ঘ
গ্রুপ  :  গ্রুপ
গ্রাহক  :  গ্রাহক
গ্রামে  :  গ্রাম
গ্রামাঞ্চলে  :  গ্রামাঞ্চল
গ্রামসমূহে  :  গ্রামসমূহ
গ্রহণের  :  গ্রহণ
গ্রন্থাগারে  :  গ্রন্থাগার
গ্রন্থাগারটি  :  গ্রন্থাগার
গ্রন্থপঞ্জি  :  গ্রন্থপঞ্জি
গ্রন্থটি  :  গ্রন্থ
গ্রন্থগুলিও  :  গ্রন্থগুলিও
গৌণ  :  গৌণ
গৌড়  :  গৌড়
গোসল  :  গোসল
গোলাকার  :  গোলাকা
গোলাকান্দাইলের  :  গোলাকান্দাইল
গোবিন্দ  :  গোবিন্দ
গোপালদি  :  গোপালদি
গোপলাপুর  :  গোপলাপু
গোপন  :  গোপন
গোদাবরীতে  :  গোদাবরী
গোড়ার  :  গোড়া
গোকুল  :  গোকুল
গেলেও  :  গেলেও
গেছেন  :  গেছেন
গেঁথে  :  গেঁথ
গৃহস্থালীর  :  গৃহস্থালী
গুসল  :  গুসল
গুল্ম  :  গুল্ম
গুলোকে  :  গুলোড
গুরুত্বের  :  গুরুত্ব
গুরুত্ববহ  :  গুরুত্ববহ
গুপ্তযুগেও  :  গুপ্তযুগেও
গুটিকাগুলিতে  :  গুটিকাগুলি
গুটিকাগুলি  :  গুটিকাগুলি
গুজরাট  :  গুজরাট
গিরিশচন্দ্র  :  গিরিশচন্দ্
গিয়ে  :  গিয়
গার্নেট  :  গার্নেট
গায়ে  :  গায়
গায়িকা  :  গায়িকা
গামলার  :  গামলা
গামছা  :  গামছা
গাড়িও  :  গাড়িও
গাড়ি  :  গাড়ি
গাঙ্গেয়  :  গাঙ্গেয়
গর্ভগৃহ  :  গর্ভগৃহ
গর্ত  :  গর্ত
গরীবুল্লাহ  :  গরীবুল্লাহ
গরিষ্ঠতা  :  গরিষ্ঠতা
গরবা  :  গরবা
গয়া  :  গয়া
গম্বুজ  :  গম্বুজ
গম  :  গম
গভীরভাবে  :  গভীরভাব
গভীরতা  :  গভীরতা
গভীরতর  :  গভীরত
গবেষণাসমূহ  :  গবেষণাসমূহ
গদ্যে  :  গদ্য
গতির  :  গতি
গড়  :  গড়
গজল  :  গজল
গঙ্গ  :  গঙ্গ
খ্রিস্টাব্দ  :  খ্রিস্টাব্দ
খ্রিস্টান  :  খ্রিস্টান
খ্রিস্টপূর্বাব্দে  :  খ্রিস্টপূর্বাব্দ
খ্রিস্টপূর্বাব্দ  :  খ্রিস্টপূর্বাব্দ
খ্রিস্টপূর্ব  :  খ্রিস্টপূর্ব
খ্রিস্ট  :  খ্রিস্ট
খোদিত  :  খোদিত
খালিজ  :  খালিজ
খানের  :  খান
খানী  :  খানী
খাদ্য  :  খাদ্য
খাতে  :  খাত
খাজের  :  খাজ
খাকী  :  খাকী
খাঁটি  :  খাঁ
খন্ডও  :  খন্ডও
খনা  :  খনা
খননকৃত  :  খননকৃত
খননকার্যের  :  খননকার্য
খড়গদের  :  খড়গ
ক্ষেত্র  :  ক্ষেত্
ক্ষুদ্রাকৃতি  :  ক্ষুদ্রাকৃতি
ক্ষুদ্রাকৃত  :  ক্ষুদ্রাকৃত
ক্ষীণ  :  ক্ষীণ
ক্ষয়প্রাপ্ত  :  ক্ষয়প্রাপ্ত
ক্ষমতাসম্পন্ন  :  ক্ষমতাসম্পন্ন
ক্ষমতায়  :  ক্ষমতায়
ক্ষতিসাধন  :  ক্ষতিসাধন
ক্লিবলিঙ্গ  :  ক্লিবলিঙ্গ
ক্লিনিক  :  ক্লিনিক
ক্রাব  :  ক্রাব
ক্রয়  :  ক্রয়
ক্রমে  :  ক্রম
ক্রমশ  :  ক্রমশ
ক্রমবিকাশের  :  ক্রমবিকাশ
ক্রমবর্ধমান  :  ক্রমবর্ধমান
ক্যালকোলিথিক  :  ক্যালকোলিথিক
ক্যাম্প  :  ক্যাম্প
ক্যামিস্ট  :  ক্যামিস্ট
ক্যান্টন  :  ক্যান্টন
ক্যানিং  :  ক্যানিং
ক্যানটন  :  ক্যানটন
কৌশলের  :  কৌশল
কৌশলগত  :  কৌশলগত
কৌশম্বির  :  কৌশম্বি
কৌণিক  :  কৌণিক
কোলের  :  কোল
কোলেকে  :  কোলেড
কোলাদানের  :  কোলাদান
কোলকাতায়  :  কোলকাতায়
কোর্স  :  কোর্স
কোর্টের  :  কোর্ট
কোর্গসহ  :  কোর্গসহ
কোর্গ  :  কোর্গ
কোনোরূপ  :  কোনোরূপ
কোনোভাবে  :  কোনোভাব
কোনোটি  :  কোন
কোনোখানে  :  কোনোখান
কোট্টপাল  :  কোট্টপাল
কোট্ট  :  কোট্ট
কোটেরপাড়  :  কোটেরপাড়
কোটের  :  কোট
কোটবাড়ি  :  কোটবাড়ি
কেন্দ্রিক  :  কেন্দ্রিক
কেন্দ্রগুলিরও  :  কেন্দ্রগুলিরও
কেনা  :  কেনা
কৃষ্ণা  :  কৃষ্ণা
কৃষিভূমির  :  কৃষিভূমি
কৃষক  :  কৃষক
কৃতকর্মের  :  কৃতকর্ম
কূপে  :  কূপ
কুসেঁ  :  কুসেঁ
কুরআনের  :  কুরআন
কুমিল্লা  :  কুমিল্লা
কুমার  :  কুমা
কুতব  :  কুতব
কুটিরশিল্প  :  কুটিরশিল্প
কীর্তিস্তম্ভকে  :  কীর্তিস্তম্ভড
কীর্তি  :  কীর্তি
কিশোরগঞ্জের  :  কিশোরগঞ্জ
কিরাআ  :  কিরাআ
কিয়াকটও  :  কিয়াকটও
কিয়াউকপিউ  :  কিয়াউকপিউ
কিমি  :  কিমি
কিভাবে  :  কিভাব
কিথ  :  কিথ
কাহিনীর  :  কাহিনী
কাহিনী  :  কাহিনী
কাশ্মীর  :  কাশ্মী
কালের  :  কাল
কালে  :  কাল
কালীমন্দিরও  :  কালীমন্দিরও
কালীবাড়ি  :  কালীবাড়ি
কালসি  :  কালসি
কার্যালয়সমূহের  :  কার্যালয়সমূহ
কার্যালয়  :  কার্যালয়
কার্যাবলির  :  কার্যাবলি
কার্যক্রমে  :  কার্যক্রম
কার্যকারিতা  :  কার্যকারিতা
কার্ড  :  কার্ড
কার্জনের  :  কার্জন
কার্জন  :  কার্জন
কারো  :  কার
কারীম  :  কারীম
কারিগর  :  কারিগ
কারাদন্ড  :  কারাদন্ড
কারণেও  :  কারণেও
কারখানা  :  কার
কায়েম  :  কায়েম
কামিল  :  কামিল
কামানঞ্চিদের  :  কামানঞ্চি
কামাঞ্চি  :  কামাঞ্চি
কামরাঙ্গীচরে  :  কামরাঙ্গীচর
কামরাঙ্গিরচর  :  কামরাঙ্গিরচ
কাব্য  :  কাব্য
কাপড়  :  কাপড়
কানুন  :  কানুন
কাতাবা  :  কাতাবা
কাঠিরহাট  :  কাঠিরহাট
কাঠামোর  :  কাঠাম
কাঠামোগত  :  কাঠামোগত
কাজেরই  :  কাজেরই
কাজটি  :  কাজ
কাজকে  :  কাজড
কাঁসর  :  কাঁস
কাঁথি  :  কাঁথি
কাঁঠাল  :  কাঁঠাল
কাঁচামাল  :  কাঁচামাল
কাঁচ  :  কাঁচ
কলেজেই  :  কলেজেই
কলেজিয়েট  :  কলেজিয়েট
কর্মসূচির  :  কর্মসূচি
কর্মচারীদের  :  কর্মচারী
কর্পূরদীপ  :  কর্পূরদীপ
কর্দমস্তর  :  কর্দমস্ত
কর্দম  :  কর্দম
কর্তৃত্বকে  :  কর্তৃত্বড
কর্তিত  :  কর্তিত
কর্ণাটকের  :  কর্ণাটক
করীম  :  করীম
করারও  :  করারও
করবেল  :  করবেল
করপাস  :  করপাস
করতো  :  করত
কয়েকটিতে  :  কয়েক
কমিটি  :  কমি
কমান্ডার  :  কমান্ডা
কমর  :  কমর
কবিকে  :  কবিড
কবরস্থানগুলি  :  কবরস্থানগুলি
কপি  :  কপি
কন্যা  :  কন্যা
কতৃক  :  কতৃক
কতটা  :  কতটা
কতগুলি  :  কতগুলি
কণা  :  কণা
কঙ্কনদিঘির  :  কঙ্কনদিঘি
কঙ্কনদিঘি  :  কঙ্কনদিঘি
কখনওই  :  কখনওই
কক্সবাজার  :  কক্সবাজা
কক্ষের  :  কক্ষ
কক্ষসমূহ  :  কক্ষসমূহ
কক্ষটি  :  কক্ষ
কওমী  :  কওমী
ওহীদের  :  ওহী
ওলন্দাজ  :  ওলন্দাজ
ওরফে  :  ওরফ
ওযিফা  :  ওযিফা
ওয়েস্টম্যাকট  :  ওয়েস্টম্যাকট
ওয়েলেসলির  :  ওয়েলেসলি
ওয়ারেন  :  ওয়ারেন
ওয়ারী  :  ওয়ারী
ওয়াজিব  :  ওয়াজিব
ওবায়দুল্লাহ  :  ওবায়দুল্লাহ
ওবায়দী  :  ওবায়দী
ওপরের  :  ওপর
ওপরও  :  ওপরও
ওজন  :  ওজন
ঐশ্বর্যশালী  :  ঐশ্বর্যশালী
ঐতিহ্যগত  :  ঐতিহ্যগত
ঐতিহাসিকভাবে  :  ঐতিহাসিকভাব
এসেছিল  :  এসেছিল
এসময়  :  এসময়
এসটি  :  এসটি
এসএমএস  :  এসএমএস
এলাকাতেই  :  এলাকাতেই
এলাকাটি  :  এলাকা
এরমধ্যে  :  এরমধ্য
এরও  :  এরও
এযুগের  :  এযুগ
এযুগে  :  এযুগ
এমনটি  :  এমন
এবাদুল  :  এবাদুল
এপিগ্রাফিকা  :  এপিগ্রাফিকা
এন্টিকয়ারি  :  এন্টিকয়ারি
এড়িয়ে  :  এড়িয়
এটিকে  :  এটিড
এটিএম  :  এটিএম
এজেন্সী  :  এজেন্সী
এগিয়ে  :  এগিয়
এখানকার  :  এখানকা
এখান  :  এখান
এক্সকাভেশন  :  এক্সকাভেশন
একাধারে  :  একাধার
একসময়  :  একসময়
একশিলা  :  একশিলা
একবচন  :  একবচন
একপক্ষ  :  একপক্ষ
একদিনের  :  একদিন
একদিকে  :  একদিড
একজনের  :  একজন
এককালে  :  এককাল
এককভাবে  :  এককভাব
একইরূপ  :  একইরূপ
ঋণসহ  :  ঋণসহ
ঋণবিতরণ  :  ঋণবিতরণ
উৎসাহ  :  উৎসাহ
উৎসর্গীকৃত  :  উৎসর্গীকৃত
উৎপাদনের  :  উৎপাদন
উৎখননসমূহের  :  উৎখননসমূহ
উৎকৃষ্টমানের  :  উৎকৃষ্টমান
উৎকর্ষ  :  উৎকর্ষ
উল্লেখ্য  :  উল্লেখ্য
উল্লম্বভাবে  :  উল্লম্বভাব
উলেখযোগ্য  :  উলেখযোগ্য
উলেকে  :  উলেড
উলামা  :  উলামা
উলা  :  উলা
উর্বর  :  উর্ব
উযু  :  উযু
উভয়ের  :  উভয়
উভয়ই  :  উভয়ই
উপায়ে  :  উপায়
উপস্থিতি  :  উপস্থিতি
উপস্থাপনে  :  উপস্থাপন
উপস্থাপন  :  উপস্থাপন
উপসাগর  :  উপসাগ
উপশহর  :  উপশহ
উপলব্ধি  :  উপলব্ধি
উপরিস্থিত  :  উপরিস্থিত
উপরিকাঠামোর  :  উপরিকাঠাম
উপরিকাঠামোটি  :  উপরিকাঠাম
উপরিকাঠামো  :  উপরিকাঠাম
উপরন্তু  :  উপরন্তু
উপরন্ত  :  উপরন্ত
উপমাদেশেও  :  উপমাদেশেও
উপমহাদেশে  :  উপমহাদেশ
উপমহাদেশ  :  উপমহাদেশ
উপভাষার  :  উপভাষা
উপনীত  :  উপনীত
উপদ্বীপ  :  উপদ্বীপ
উপত্যকার  :  উপত্যকা
উপজীব্য  :  উপজীব্য
উপজাতীয়  :  উপজাতীয়
উপজাতি  :  উপজাতি
উপকূলের  :  উপকূল
উপকূলেও  :  উপকূলেও
উপকরণগুলি  :  উপকরণগুলি
উপ  :  উপ
উন্মোচনে  :  উন্মোচন
উন্মোচন  :  উন্মোচন
উন্মুক্ত  :  উন্মুক্ত
উন্নীত  :  উন্নীত
উন্নতি  :  উন্নতি
উদ্যোগ  :  উদ্যোগ
উদ্যোক্তার  :  উদ্যোক্তা
উদ্যোক্তা  :  উদ্যোক্তা
উদ্যানতত্ত্বের  :  উদ্যানতত্ত্ব
উদ্যানতত্ত্বকে  :  উদ্যানতত্ত্বড
উদ্ভাবনে  :  উদ্ভাবন
উদ্ধারে  :  উদ্ধার
উদ্ধার  :  উদ্ধা
উদ্দেশ্য  :  উদ্দেশ্য
উদ্ঘাটনলপ্রভৃতি  :  উদ্ঘাটনলপ্রভৃতি
উদ্  :  উদ্
উদীয়মান  :  উদীয়মান
উদাহরণস্বরূপ  :  উদাহরণস্বরূপ
উত্থাপিত  :  উত্থাপিত
উত্থাপন  :  উত্থাপন
উত্তোলনযোগ্য  :  উত্তোলনযোগ্য
উত্তেজনা  :  উত্তেজনা
উত্তরে  :  উত্তর
উত্তরবঙ্গের  :  উত্তরবঙ্গ
উত্তরকালে  :  উত্তরকাল
উত্তম  :  উত্তম
উড়িষ্যা  :  উড়িষ্যা
উড়িয়ে  :  উড়িয়
উঠানামার  :  উঠানামা
উজ্জ্বল  :  উজ্জ্বল
উজির  :  উজি
উচ্চারণে  :  উচ্চারণ
উচ্চারণ  :  উচ্চারণ
উচ্চশিক্ষার  :  উচ্চশিক্ষা
উচ্চতাবিশিষ্ট  :  উচ্চতাবিশিষ্ট
উচ্চতা  :  উচ্চতা
উচ্চতর  :  উচ্চত
উচ্চতম  :  উচ্চতম
উচিতপুর  :  উচিতপু
উইলিয়ম  :  উইলিয়ম
উঁচু  :  উঁচু
ঈমান  :  ঈমান
ইস্টার্ণ  :  ইস্টার্ণ
ইসলামি  :  ইসলামি
ইলমুল  :  ইলমুল
ইয়োমা  :  ইয়োমা
ইয়াহিয়া  :  ইয়াহিয়া
ইয়াক্কা  :  ইয়াক্কা
ইয়া  :  ইয়া
ইমারতই  :  ইমারতই
ইমদাদিয়া  :  ইমদাদিয়া
ইব্ন  :  ইব্ন
ইপিগ্রাফিক্যাল  :  ইপিগ্রাফিক্যাল
ইন্সক্রিপশনাম  :  ইন্সক্রিপশনাম
ইন্দ্রজির  :  ইন্দ্রজি
ইন্ডিকারাম  :  ইন্ডিকারাম
ইন্ডিকা  :  ইন্ডিকা
ইন্টারনেট  :  ইন্টারনেট
ইনকর্পোরেটেড  :  ইনকর্পোরেটেড
ইত্যাদিও  :  ইত্যাদিও
ইতিহাস্ল  :  ইতিহাস্ল
ইতিহাসবেত্তা  :  ইতিহাসবেত্তা
ইতিহাসকে  :  ইতিহাসড
ইটাখোলামুড়া  :  ইটাখোলামুড়া
ইটাখোলা  :  ইটাখোলা
ইঞ্জিনিয়ার্সের  :  ইঞ্জিনিয়ার্স
ইগেলিং  :  ইগেলিং
ইউরোপে  :  ইউরোপ
ইউনাইটেড  :  ইউনাইটেড
ইংরেজিকেও  :  ইংরেজিকেও
ইংরেজরা  :  ইংরেজর
ইংরেজদের  :  ইংরেজ
আহবান  :  আহবান
আস্তর  :  আস্ত
আসার  :  আসা
আসলে  :  আসল
আস  :  আস
আশেপাশে  :  আশেপাশ
আশে  :  আশে
আশরফপুরের  :  আশরফপুর
আল্লামা  :  আল্লামা
আলোচনাপূর্বক  :  আলোচনাপূর্বক
আলোকে  :  আলোড
আলোকপাত  :  আলোকপাত
আলেম  :  আলেম
আলেকজান্দ্রিয়া  :  আলেকজান্দ্রিয়া
আলু  :  আলু
আলী  :  আলী
আলিম  :  আলিম
আলাদাভাবে  :  আলাদাভাব
আলাউদ্দীন  :  আলাউদ্দীন
আলমের  :  আলম
আর্সেনিকের  :  আর্সেনিক
আর্ন্তজাতিক  :  আর্ন্তজাতিক
আর্থিক  :  আর্থিক
আর্কিওলজি  :  আর্কিওলজি
আরোও  :  আরোও
আরো  :  আরো
আরেক  :  আরেক
আরিকামেদু  :  আরিকামেদু
আরাকানরা  :  আরাকানর
আরাকানকে  :  আরাকানড
আরবে  :  আরব
আরবরা  :  আরবর
আরবদেশ  :  আরবদেশ
আরবদেরকে  :  আরব
আরবগণ  :  আরবগণ
আরতি  :  আরতি
আয়ের  :  আয়
আয়ত্বে  :  আয়ত্ব
আয়তন  :  আয়তন
আম্রপল্লব  :  আম্রপল্লব
আম্মা  :  আম্মা
আমানত  :  আমানত
আমলে  :  আমল
আমন্ত্রণ  :  আমন্ত্রণ
আমদানি  :  আমদা
আম  :  আম
আবেদনের  :  আবেদন
আবেদনে  :  আবেদন
আবেদনক্রমে  :  আবেদনক্রম
আবৃত  :  আবৃত
আবুতাওয়ামা  :  আবুতাওয়ামা
আবিসিনিয়ান  :  আবিসিনিয়ান
আবিষ্কারের  :  আবিষ্কার
আবিষ্কারে  :  আবিষ্কার
আবির্ভাবের  :  আবির্ভাব
আবির্ভাব  :  আবির্ভাব
আবাসনের  :  আবাসন
আবাসনও  :  আবাসনও
আববাস  :  আববাস
আববা  :  আববা
আবগারী  :  আবগারী
আপ্যায়ন  :  আপ্যায়ন
আপোস  :  আপোস
আন্দোলনের  :  আন্দোলন
আন্তঃসংযোগসম্পন্ন  :  আন্তঃসংযোগসম্পন্ন
আনে  :  আনে
আনতে  :  আনত
আদেশের  :  আদেশ
আদিবাসী  :  আদিবাসী
আদিনাথ  :  আদিনাথ
আদায়ের  :  আদায়
আদায়  :  আদায়
আদলে  :  আদল
আদর্শ  :  আদর্শ
আদম  :  আদম
আত্মনিবেদিত  :  আত্মনিবেদিত
আড়াআড়িভাবে  :  আড়াআড়িভাব
আড়ত  :  আড়ত
আঠারো  :  আঠার
আটি  :  আটি
আটক  :  আটক
আছেন  :  আছেন
আচ্ছাদিত  :  আচ্ছাদিত
আঙ্গিনায়  :  আঙ্গিনায়
আগ্রায়  :  আগ্রায়
আগ্রহ  :  আগ্রহ
আগুনে  :  আগুন
আগুইবাড়ি  :  আগুইবাড়ি
আগলী  :  আগলী
আগত  :  আগত
আগ  :  আগ
আকৃতির  :  আকৃতি
আকিয়াব  :  আকিয়াব
আকিদাহ  :  আকিদাহ
আকর্ষণীয়  :  আকর্ষণীয়
আওরঙ্গজেব  :  আওরঙ্গজেব
আউলিয়াদের  :  আউলিয়া
আইনসমূহ  :  আইনসমূহ
আইনজীবী  :  আইনজীবী
আইএ  :  আইএ
অ্যাসেসর  :  অ্যাসেস
অ্যান্টিকুইটি  :  অ্যান্টিকুই
অ্যাক্ট  :  অ্যাক্ট
অহিচছাত্রায়  :  অহিচছাত্রায়
অহিচছাত্রা  :  অহিচছাত্র
অস্থিতিশীল  :  অস্থিতিশীল
অস্থায়ী  :  অস্থায়ী
অসহযোগিতার  :  অসহযোগিতা
অসম্পূর্ণ  :  অসম্পূর্ণ
অসদাচরণ  :  অসদাচরণ
অষ্টম  :  অষ্টম
অল্পদিনের  :  অল্পদিন
অলি  :  অলি
অলঙ্কার  :  অলঙ্কা
অলঙ্করণে  :  অলঙ্করণ
অলংকৃত  :  অলংকৃত
অলংকার  :  অলংকা
অর্পিত  :  অর্পিত
অর্পণ  :  অর্পণ
অর্ধেক  :  অর্ধেক
অর্ধাবদ্ধ  :  অর্ধাবদ্ধ
অর্ধ  :  অর্ধ
অর্থে  :  অর্থ
অর্জনের  :  অর্জন
অর্গিল  :  অর্গিল
অর্কা  :  অর্কা
অযোধ্যার  :  অযোধ্যা
অমুসলিমরাও  :  অমুসলিমরাও
অভ্যস্ত  :  অভ্যস্ত
অভ্যন্তরস্থ  :  অভ্যন্তরস্থ
অভূতপূর্ব  :  অভূতপূর্ব
অভিহিত  :  অভিহিত
অভিসন্দর্ভসমূহের  :  অভিসন্দর্ভসমূহ
অভিলেখনের  :  অভিলেখন
অভিলিখনের  :  অভিলিখন
অভিবাসী  :  অভিবাসী
অভিবাসিত  :  অভিবাসিত
অভিবাসন  :  অভিবাসন
অভাবে  :  অভাব
অভাব  :  অভাব
অব্যয়  :  অব্যয়
অবৈতনিক  :  অবৈতনিক
অবস্থিতি  :  অবস্থিতি
অবস্থায়  :  অবস্থায়
অবস্থানের  :  অবস্থান
অবস্থাতেই  :  অবস্থাতেই
অবশ্যপালনীয়  :  অবশ্যপালনীয়
অবলোকিতেশ্বরের  :  অবলোকিতেশ্বর
অবয়বের  :  অবয়ব
অবদানের  :  অবদান
অবকাঠামো  :  অবকাঠাম
অপ্রতুল  :  অপ্রতুল
অপেক্ষা  :  অপেক্ষা
অপরিহার্য  :  অপরিহার্য
অপভ্রংশ  :  অপভ্রংশ
অন্যায়  :  অন্যায়
অন্যান্যরা  :  অন্যান্যর
অন্যান্যদের  :  অন্যান্য
অন্যভাগ  :  অন্যভাগ
অন্যত্র  :  অন্যত্
অন্যটি  :  অন্য
অন্বেষণে  :  অন্বেষণ
অন্বেষণ  :  অন্বেষণ
অন্তর্বর্তী  :  অন্তর্বর্তী
অনেকগুলি  :  অনেকগুলি
অনেককেই  :  অনেককেই
অনেককাল  :  অনেককাল
অনুসরণে  :  অনুসরণ
অনুসন্ধানকারী  :  অনুসন্ধানকারী
অনুষ্ঠিত  :  অনুষ্ঠিত
অনুলিয়া  :  অনুলিয়া
অনুরোধে  :  অনুরোধ
অনুরোধ  :  অনুরোধ
অনুযায়ীও  :  অনুযায়ীও
অনুমোদনের  :  অনুমোদন
অনুমোদনক্রমে  :  অনুমোদনক্রম
অনুমানিক  :  অনুমানিক
অনুমানলব্ধ  :  অনুমানলব্ধ
অনুমান  :  অনুমান
অনুভূমিকভাবে  :  অনুভূমিকভাব
অনুবাদ  :  অনুবাদ
অনুপস্থিতিতে  :  অনুপস্থিতি
অনুপস্থিত  :  অনুপস্থিত
অনুচিত  :  অনুচিত
অনুকপি  :  অনুকপি
অনীস  :  অনীস
অনানুষ্ঠানিকভাবে  :  অনানুষ্ঠানিকভাব
অধ্যাপনা  :  অধ্যাপনা
অধ্যাপক  :  অধ্যাপক
অধুনা  :  অধুনা
অধিবাসীর  :  অধিবাসী
অধিবাসী  :  অধিবাসী
অধিপতি  :  অধিপতি
অধিদপ্তর  :  অধিদপ্ত
অধিকারী  :  অধিকারী
অধিকতর  :  অধিকত
অত্যুৎসাহী  :  অত্যুৎসাহী
অত্যধিক  :  অত্যধিক
অতীতের  :  অতীত
অতিসম্প্রতি  :  অতিসম্প্রতি
অতিথি  :  অতিথি
অতঃপর  :  অতঃপ
অট্টণালিকাসমূহের  :  অট্টণালিকাসমূহ
অঞ্জলিকা  :  অঞ্জলিকা
অঞ্চলেরই  :  অঞ্চলেরই
অঞ্চলটি  :  অঞ্চল
অঙ্গরাজ্য  :  অঙ্গরাজ্য
অঙ্গবিশেষ  :  অঙ্গবিশেষ
অঙ্গনে  :  অঙ্গন
অঙ্কিত  :  অঙ্কিত
অঙ্কন  :  অঙ্কন
অগ্রাধিকার  :  অগ্রাধিকা
অগ্রভাগ  :  অগ্রভাগ
অগ্রগতি  :  অগ্রগতি
অগভীর  :  অগভী
অখোদিত  :  অখোদিত
অক্ষাংশ  :  অক্ষাংশ
অক্ষয়কুমার  :  অক্ষয়কুমা
অক্ষদন্ড  :  অক্ষদন্ড
অক্লান্তভাবে  :  অক্লান্তভাব
অক্লান্ত  :  অক্লান্ত
অক্টোবর  :  অক্টোব
অংশবিশেষ  :  অংশবিশেষ
অংশটি  :  অংশ
অংকশাস্ত্র  :  অংকশাস্ত্
